,low,high,range,size,merge_time,count_time,comb_time,shell_time,heap_time
0,2818,8284,5466,3093,38.57779502868652,5.026102066040039,39.62302207946777,21.84581756591797,39.27493095397949
1,670,4248,3578,1619,13.89002799987793,1.6779899597167969,13.151884078979492,9.714365005493164,18.388986587524414
2,7241,8992,1751,1087,8.765935897827148,1.9867420196533203,8.860349655151367,5.738973617553711,11.44719123840332
3,5397,6516,1119,3985,38.771867752075195,3.4668445587158203,36.640167236328125,26.002883911132812,56.88810348510742
4,388,4117,3729,2563,23.463964462280273,2.252817153930664,21.923065185546875,16.245126724243164,30.858278274536133
5,1693,7773,6080,4276,41.809797286987305,3.9479732513427734,40.086984634399414,32.44495391845703,56.62989616394043
6,4633,8216,3583,4210,43.10011863708496,6.097078323364258,43.80917549133301,28.535127639770508,54.586172103881836
7,2524,5996,3472,4697,46.44775390625,3.873109817504883,45.76873779296875,32.823801040649414,62.934160232543945
8,4124,6775,2651,4165,40.90595245361328,3.668069839477539,42.49000549316406,28.187036514282227,53.61509323120117
9,3269,9003,5734,245,1.4681816101074219,1.4216899871826172,1.3060569763183594,0.8740425109863281,1.9462108612060547
10,5245,7810,2565,2498,25.025129318237305,3.0999183654785156,25.744915008544922,16.331195831298828,29.476165771484375
11,546,9577,9031,231,1.3628005981445312,1.5108585357666016,1.2989044189453125,0.8361339569091797,1.8050670623779297
12,1215,3919,2704,777,5.864858627319336,1.0840892791748047,5.645751953125,3.8471221923828125,7.7610015869140625
13,1467,2531,1064,4199,41.38588905334473,2.972841262817383,39.58296775817871,27.454137802124023,54.6112060546875
14,1830,3894,2064,4774,47.49417304992676,3.5572052001953125,49.59702491760254,34.74903106689453,62.82496452331543
15,600,2978,2378,2592,24.891138076782227,2.08282470703125,21.78788185119629,16.135215759277344,31.423091888427734
16,2765,9982,7217,1535,13.06605339050293,2.471923828125,12.23301887512207,8.77690315246582,17.100095748901367
17,9032,9489,457,795,6.156206130981445,1.8796920776367188,5.703926086425781,3.921985626220703,7.993936538696289
18,3811,4170,359,4152,40.285348892211914,3.1669139862060547,35.749197006225586,25.234222412109375,56.04290962219238
19,2023,4684,2661,131,0.7231235504150391,0.7412433624267578,0.5860328674316406,0.40531158447265625,0.8921623229980469
20,661,5795,5134,788,6.018161773681641,1.361846923828125,5.533933639526367,3.911256790161133,7.848262786865234
21,3498,8487,4989,2586,23.5288143157959,2.8963088989257812,22.46570587158203,16.60299301147461,31.2960147857666
22,1907,8298,6391,1060,8.469104766845703,1.9350051879882812,10.180234909057617,6.289958953857422,11.31296157836914
23,3558,9594,6036,3304,31.183242797851562,3.5371780395507812,28.975725173950195,21.715879440307617,41.0308837890625
24,6616,9254,2638,3032,30.040740966796875,3.361940383911133,28.08976173400879,21.445751190185547,38.3458137512207
25,450,1463,1013,1491,12.556791305541992,1.157999038696289,11.328697204589844,8.262157440185547,16.50691032409668
26,1179,3790,2611,1068,9.450197219848633,1.341104507446289,9.296178817749023,5.712747573852539,11.208772659301758
27,1291,1832,541,1780,15.452861785888672,1.3668537139892578,14.749288558959961,11.657953262329102,21.420955657958984
28,29,5634,5605,798,7.255077362060547,1.3811588287353516,5.623102188110352,5.386114120483398,8.653879165649414
29,963,1792,829,2062,22.035837173461914,1.5501976013183594,18.416881561279297,12.174844741821289,24.0020751953125
30,1400,1611,211,2173,19.444942474365234,1.5377998352050781,17.345905303955078,12.219905853271484,25.50506591796875
31,1501,1916,415,167,0.9410381317138672,0.3807544708251953,0.8218288421630859,0.5548000335693359,1.2159347534179688
32,7333,8998,1665,3906,38.17296028137207,3.737926483154297,38.02227973937988,25.75993537902832,55.64093589782715
33,1000,6082,5082,3171,33.49018096923828,3.2439231872558594,36.448001861572266,23.86474609375,46.76699638366699
34,2592,6315,3723,3634,45.057058334350586,3.6809444427490234,43.03574562072754,28.202295303344727,53.305864334106445
35,339,2421,2082,2319,25.249004364013672,2.5873184204101562,22.93086051940918,17.539024353027344,32.872915267944336
36,1036,6325,5289,761,7.042884826660156,2.331972122192383,5.962848663330078,5.091190338134766,9.325027465820312
37,673,2808,2135,1709,18.743038177490234,1.4998912811279297,15.890836715698242,11.758804321289062,21.970033645629883
38,4189,4754,565,4899,57.869911193847656,5.373239517211914,55.96804618835449,43.78700256347656,78.29475402832031
39,552,9955,9403,4910,53.2231330871582,4.827022552490234,49.685001373291016,38.38205337524414,71.57564163208008
40,884,4777,3893,3765,39.66808319091797,3.400087356567383,37.95194625854492,27.067899703979492,50.81915855407715
41,557,5231,4674,83,0.4191398620605469,0.858306884765625,0.35309791564941406,0.23317337036132812,0.5209445953369141
42,6061,9431,3370,987,7.806062698364258,2.0020008087158203,8.294820785522461,5.416154861450195,11.458873748779297
43,1142,3632,2490,1260,10.671138763427734,1.5060901641845703,10.504961013793945,7.32111930847168,14.051675796508789
44,174,9632,9458,1969,17.773151397705078,2.969980239868164,16.36791229248047,12.047767639160156,23.255109786987305
45,2517,7024,4507,4519,50.5068302154541,4.038095474243164,49.252986907958984,33.814191818237305,63.09819221496582
46,1397,9860,8463,2844,28.9609432220459,4.415988922119141,26.600122451782227,18.887042999267578,44.693946838378906
47,4539,6820,2281,4825,52.23226547241211,4.509925842285156,47.37520217895508,33.52093696594238,66.98274612426758
48,3233,8926,5693,338,2.161264419555664,1.4929771423339844,1.912832260131836,2.1262168884277344,4.415988922119141
49,5568,8315,2747,703,5.89299201965332,1.7521381378173828,4.879951477050781,3.4842491149902344,7.00688362121582
50,3430,5376,1946,2774,29.10470962524414,2.5739669799804688,26.081085205078125,17.372846603393555,34.1639518737793
51,1357,7313,5956,534,3.7908554077148438,1.4290809631347656,3.3969879150390625,2.424001693725586,4.972934722900391
52,1335,1612,277,2871,29.592037200927734,1.9659996032714844,23.868799209594727,17.132997512817383,36.10682487487793
53,1194,2501,1307,3638,39.86787796020508,2.7337074279785156,33.26988220214844,23.572921752929688,46.701908111572266
54,2491,7068,4577,4244,41.296958923339844,3.7450790405273438,39.44087028503418,28.822898864746094,55.819034576416016
55,6263,9373,3110,1609,14.405250549316406,3.7109851837158203,12.452125549316406,9.082317352294922,18.141984939575195
56,4889,6470,1581,3326,31.131982803344727,3.015756607055664,28.72490882873535,22.563695907592773,46.55885696411133
57,9046,9971,925,3152,35.077810287475586,3.706216812133789,34.087181091308594,21.142005920410156,39.17098045349121
58,4795,9204,4409,4941,50.87995529174805,5.837917327880859,49.018144607543945,33.531904220581055,66.03813171386719
59,788,6643,5855,912,7.243871688842773,1.6849040985107422,6.413936614990234,4.805803298950195,9.419918060302734
60,1767,7709,5942,2226,22.586822509765625,2.599954605102539,19.173860549926758,13.683080673217773,26.195049285888672
61,675,7519,6844,1299,10.81705093383789,1.9793510437011719,12.212038040161133,7.225990295410156,14.13106918334961
62,3662,8465,4803,2160,19.226789474487305,2.638101577758789,18.578290939331055,13.960838317871094,28.11908721923828
63,651,5869,5218,2348,21.368741989135742,2.402067184448242,21.0268497467041,14.492273330688477,27.825117111206055
64,3270,7671,4401,1516,12.832164764404297,2.111196517944336,11.838197708129883,8.498191833496094,16.914844512939453
65,4723,7130,2407,784,5.962133407592773,1.5323162078857422,5.509138107299805,3.851175308227539,7.848024368286133
66,925,3259,2334,4800,48.13790321350098,3.4711360931396484,49.31902885437012,35.104990005493164,66.18809700012207
67,1471,7375,5904,3660,35.06588935852051,4.267692565917969,36.33713722229004,25.513887405395508,48.294782638549805
68,1660,4328,2668,471,3.2501220703125,0.9288787841796875,3.040790557861328,2.1560192108154297,4.264116287231445
69,1719,9214,7495,4306,41.821956634521484,4.321098327636719,40.65680503845215,29.166221618652344,57.58404731750488
70,3951,6061,2110,859,6.911993026733398,1.4362335205078125,6.920099258422852,4.460811614990234,8.717060089111328
71,1093,6307,5214,3309,34.31296348571777,3.0748844146728516,29.166221618652344,22.132158279418945,41.48292541503906
72,142,1133,991,4221,40.88568687438965,2.752065658569336,38.94186019897461,26.92413330078125,55.387258529663086
73,1390,5860,4470,2262,20.546913146972656,2.473115921020508,20.85089683532715,13.776779174804688,26.91483497619629
74,1303,4307,3004,2581,23.530960083007812,2.2678375244140625,22.114038467407227,16.420841217041016,31.663894653320312
75,2429,7332,4903,4650,46.01001739501953,4.066944122314453,45.197248458862305,33.69283676147461,61.02395057678223
76,4977,9565,4588,4456,48.890113830566406,4.385948181152344,51.62501335144043,31.81910514831543,61.92302703857422
77,4221,9560,5339,4031,38.83004188537598,4.0493011474609375,38.95282745361328,27.24289894104004,55.01580238342285
78,4256,4758,502,157,0.8738040924072266,0.7710456848144531,0.7100105285644531,0.4849433898925781,1.1250972747802734
79,6392,8035,1643,4312,42.01102256774902,3.824949264526367,38.65194320678711,28.297901153564453,55.59206008911133
80,1467,2958,1491,3094,28.748035430908203,2.389192581176758,28.333187103271484,19.57225799560547,38.6810302734375
81,2625,9920,7295,2422,21.921157836914062,3.0438899993896484,22.5527286529541,15.126943588256836,28.897762298583984
82,175,3043,2868,1403,11.602163314819336,1.402139663696289,13.382911682128906,8.960962295532227,17.269134521484375
83,7685,9702,2017,555,3.9763450622558594,1.753091812133789,3.6737918853759766,2.541065216064453,5.197048187255859
84,2442,9326,6884,2495,22.58467674255371,3.046274185180664,22.691965103149414,15.34724235534668,29.957056045532227
85,7344,9038,1694,553,3.9932727813720703,1.6522407531738281,3.9000511169433594,2.939939498901367,5.7010650634765625
86,2696,6588,3892,1183,9.613037109375,1.7311573028564453,9.04393196105957,6.411075592041016,12.665033340454102
87,1664,6230,4566,557,3.9529800415039062,1.2590885162353516,3.9560794830322266,2.501964569091797,5.3119659423828125
88,5717,9037,3320,420,2.942323684692383,1.6970634460449219,2.6450157165527344,1.7681121826171875,4.29081916809082
89,4478,7591,3113,1139,10.802984237670898,1.8949508666992188,8.93712043762207,6.086826324462891,13.486862182617188
90,35,7169,7134,670,5.36799430847168,1.519918441772461,5.09190559387207,3.3652782440185547,6.469249725341797
91,1772,5105,3333,2301,24.483203887939453,2.382040023803711,21.2252140045166,16.52979850769043,27.324199676513672
92,2648,7523,4875,2651,24.522066116333008,2.8181076049804688,25.938749313354492,16.576051712036133,32.3939323425293
93,3373,5583,2210,1224,10.017633438110352,1.5900135040283203,10.962963104248047,6.578922271728516,13.191938400268555
94,3002,6233,3231,4703,46.4017391204834,3.8909912109375,46.087026596069336,31.892061233520508,61.71298027038574
95,387,709,322,2484,22.573232650756836,1.6398429870605469,19.870996475219727,13.958215713500977,29.71506118774414
96,766,6294,5528,2243,20.949840545654297,2.566099166870117,20.071029663085938,13.895988464355469,26.601076126098633
97,739,1884,1145,4008,38.76614570617676,2.750873565673828,37.70112991333008,25.76303482055664,54.88705635070801
98,6037,6327,290,4693,48.10786247253418,4.328012466430664,40.34876823425293,28.373003005981445,63.981056213378906
99,2999,9292,6293,4198,46.76413536071777,4.420995712280273,46.99230194091797,30.865192413330078,54.5809268951416
100,4946,6647,1701,1392,12.074947357177734,2.1109580993652344,11.533260345458984,7.835865020751953,15.246152877807617
101,2551,7071,4520,2834,26.144981384277344,2.8710365295410156,25.496959686279297,18.114805221557617,34.323930740356445
102,3160,6651,3491,4092,39.63494300842285,3.6139488220214844,40.8778190612793,27.572154998779297,52.45709419250488
103,4405,5535,1130,2779,25.651931762695312,2.5191307067871094,24.611234664916992,17.1658992767334,34.59501266479492
104,1533,5448,3915,800,6.326198577880859,1.3279914855957031,6.142139434814453,4.025936126708984,8.138895034790039
105,3210,3530,320,3145,29.44326400756836,2.4290084838867188,26.22365951538086,18.16391944885254,38.98787498474121
106,5166,7719,2553,3184,30.332088470458984,3.1290054321289062,29.716014862060547,20.24388313293457,40.1301383972168
107,9105,9914,809,4791,47.30701446533203,4.410743713378906,48.719167709350586,34.69514846801758,67.7030086517334
108,3327,3535,208,843,6.974220275878906,1.0349750518798828,5.7659149169921875,3.9920806884765625,10.737180709838867
109,3407,9086,5679,3180,31.39805793762207,3.4008026123046875,29.319047927856445,20.86782455444336,42.53387451171875
110,5630,8416,2786,2763,25.498151779174805,2.991199493408203,25.523900985717773,17.353057861328125,33.849239349365234
111,805,6885,6080,4320,42.391061782836914,3.799915313720703,39.35599327087402,29.543161392211914,55.56988716125488
112,4077,8899,4822,1578,13.400793075561523,2.340078353881836,13.568639755249023,9.218931198120117,17.774105072021484
113,2301,8706,6405,2939,29.772043228149414,3.3681392669677734,27.41408348083496,18.855810165405273,36.16476058959961
114,1636,5407,3771,4657,45.614004135131836,3.7298202514648438,45.134782791137695,32.441139221191406,61.08999252319336
115,1802,6096,4294,1609,13.833999633789062,1.9350051879882812,13.822078704833984,9.467124938964844,21.218061447143555
116,4141,6187,2046,2669,24.66607093811035,4.395008087158203,27.996063232421875,17.998933792114258,36.75699234008789
117,5852,8442,2590,1126,10.075092315673828,2.1390914916992188,10.173797607421875,8.401870727539062,13.768196105957031
118,9043,9533,490,2502,24.39713478088379,2.9020309448242188,20.467758178710938,14.663934707641602,29.95896339416504
119,4762,9127,4365,3337,31.53681755065918,3.4689903259277344,33.288002014160156,24.988174438476562,44.33393478393555
120,1123,7495,6372,2967,27.783870697021484,3.057718276977539,27.951955795288086,19.158124923706055,36.42106056213379
121,4241,8818,4577,4177,40.77911376953125,3.971099853515625,40.4210090637207,27.955055236816406,54.82006072998047
122,401,8224,7823,1472,12.487173080444336,2.2089481353759766,11.741876602172852,8.516788482666016,16.337871551513672
123,547,8195,7648,338,2.1669864654541016,1.4040470123291016,1.9869804382324219,1.3141632080078125,2.892017364501953
124,4170,5584,1414,3448,32.55486488342285,2.938985824584961,33.45513343811035,22.809743881225586,45.48788070678711
125,3380,7632,4252,3943,37.85967826843262,3.6401748657226562,37.978172302246094,26.544809341430664,50.14491081237793
126,175,6571,6396,638,4.6520233154296875,1.4090538024902344,4.459142684936523,3.000020980834961,6.140947341918945
127,3741,5888,2147,668,4.897117614746094,1.2819766998291016,5.318880081176758,3.4019947052001953,6.690025329589844
128,8846,9796,950,689,5.421161651611328,2.0558834075927734,4.685878753662109,3.328084945678711,8.304119110107422
129,2965,3608,643,4522,49.90506172180176,3.810882568359375,46.29802703857422,31.404972076416016,64.17298316955566
130,7220,9051,1831,68,0.3268718719482422,1.33514404296875,0.2460479736328125,0.18596649169921875,0.3972053527832031
131,2861,8152,5291,1440,14.981269836425781,2.2940635681152344,12.282133102416992,8.289098739624023,16.157150268554688
132,367,3095,2728,3120,28.986215591430664,2.4192333221435547,29.28304672241211,19.76299285888672,38.56015205383301
133,2270,6778,4508,4256,41.3358211517334,3.6988258361816406,39.919137954711914,28.63001823425293,55.01961708068848
134,2513,9182,6669,2169,19.877195358276367,2.901315689086914,18.548011779785156,13.090133666992188,28.77211570739746
135,1582,5519,3937,316,1.9698143005371094,0.9951591491699219,1.7600059509277344,1.313924789428711,2.6612281799316406
136,3262,5914,2652,4264,41.25571250915527,3.5262107849121094,38.451194763183594,28.020858764648438,57.80220031738281
137,2391,9185,6794,3583,34.307003021240234,3.6530494689941406,35.6447696685791,23.869991302490234,46.67305946350098
138,8337,8913,576,122,0.7359981536865234,1.4369487762451172,0.5888938903808594,0.3921985626220703,0.8947849273681641
139,1212,2754,1542,1234,10.051965713500977,1.1730194091796875,9.785175323486328,6.607770919799805,14.046907424926758
140,7703,8268,565,4591,47.11294174194336,5.460023880004883,47.0728874206543,29.343843460083008,60.073137283325195
141,444,732,288,4343,42.35100746154785,2.7625560760498047,37.522077560424805,25.836944580078125,56.92291259765625
142,939,1094,155,3708,38.59877586364746,2.4230480194091797,30.96914291381836,20.792007446289062,46.78821563720703
143,6172,6327,155,942,7.404088973999023,1.4829635620117188,8.511781692504883,6.082057952880859,10.135889053344727
144,3226,5958,2732,633,4.626274108886719,1.2691020965576172,4.215002059936523,2.9659271240234375,6.059169769287109
145,1273,8277,7004,4459,44.471025466918945,4.098176956176758,49.2708683013916,30.44867515563965,58.753013610839844
146,1960,9633,7673,1253,10.272979736328125,2.4111270904541016,9.71078872680664,6.942987442016602,15.564918518066406
147,4636,8122,3486,2110,18.739938735961914,2.527952194213867,20.48516273498535,12.727022171020508,24.535179138183594
148,7998,8236,238,1677,17.127037048339844,2.5708675384521484,12.591838836669922,8.962154388427734,19.00005340576172
149,4744,8986,4242,2273,23.720979690551758,2.8340816497802734,23.061037063598633,15.17486572265625,29.66785430908203
150,841,9196,8355,2375,27.661800384521484,2.9430389404296875,20.85089683532715,17.017841339111328,29.977083206176758
151,2353,4881,2528,3829,37.56594657897949,3.114938735961914,35.594940185546875,25.321006774902344,48.67887496948242
152,495,9483,8988,4427,43.99394989013672,4.290103912353516,48.71225357055664,31.37993812561035,57.85799026489258
153,2012,8772,6760,323,2.138853073120117,1.4679431915283203,2.093076705932617,1.2881755828857422,2.7341842651367188
154,5407,8657,3250,3517,33.77199172973633,5.074262619018555,33.661842346191406,28.51271629333496,45.34292221069336
155,4125,9016,4891,1133,9.22393798828125,2.465963363647461,10.335922241210938,6.112098693847656,12.185096740722656
156,4039,6457,2418,388,2.584218978881836,1.1680126190185547,2.412080764770508,1.6279220581054688,3.3991336822509766
157,5394,6964,1570,4811,47.7597713470459,3.990650177001953,48.477888107299805,33.42485427856445,63.67611885070801
158,4613,6026,1413,1229,10.034799575805664,1.6388893127441406,12.44807243347168,6.72602653503418,13.267040252685547
159,5776,7752,1976,3091,28.816938400268555,3.0579566955566406,30.95412254333496,21.017789840698242,38.94996643066406
160,4968,5389,421,2093,18.639802932739258,2.0589828491210938,16.847848892211914,12.343168258666992,24.97100830078125
161,2397,9321,6924,2371,21.322965621948242,2.956867218017578,23.08201789855957,14.571905136108398,30.833959579467773
162,3261,8439,5178,32,0.1399517059326172,1.2118816375732422,0.09274482727050781,0.07414817810058594,0.14781951904296875
163,6638,9754,3116,2623,24.471759796142578,3.1638145446777344,24.910926818847656,16.402006149291992,34.74283218383789
164,4719,5638,919,1549,13.13018798828125,1.7690658569335938,12.906074523925781,9.819984436035156,17.44675636291504
165,3071,5206,2135,1238,10.107040405273438,1.5380382537841797,9.593009948730469,6.828784942626953,13.340950012207031
166,1517,2991,1474,1159,9.431838989257812,1.1641979217529297,9.184122085571289,6.612300872802734,12.527227401733398
167,4,7485,7481,4696,51.137685775756836,4.124879837036133,45.706987380981445,33.676862716674805,62.088966369628906
168,2929,9987,7058,1139,9.261131286621094,2.234935760498047,8.477926254272461,6.149768829345703,12.05301284790039
169,4798,7679,2881,213,1.2497901916503906,1.2362003326416016,1.0750293731689453,0.7467269897460938,1.6338825225830078
170,535,6934,6399,115,0.5981922149658203,1.0380744934082031,0.5581378936767578,0.33020973205566406,0.7500648498535156
171,5639,7269,1630,2035,18.081188201904297,2.3360252380371094,18.200159072875977,14.315128326416016,28.242826461791992
172,1819,6058,4239,1400,11.652231216430664,1.8129348754882812,11.312007904052734,7.895946502685547,15.534162521362305
173,5676,7569,1893,3116,29.134750366210938,3.034830093383789,28.719186782836914,22.898197174072266,40.16685485839844
174,7412,8828,1416,2077,18.492937088012695,2.5730133056640625,18.531084060668945,12.376070022583008,26.092052459716797
175,7114,9168,2054,1842,17.644166946411133,2.8579235076904297,16.668081283569336,11.31296157836914,22.778034210205078
176,3112,9452,6340,4805,50.02593994140625,6.355047225952148,47.94883728027344,33.531904220581055,64.29386138916016
177,7466,8250,784,4360,43.61319541931152,3.9620399475097656,39.80302810668945,27.83799171447754,59.81111526489258
178,2084,9399,7315,3860,36.97514533996582,3.8862228393554688,37.6279354095459,26.244163513183594,51.53989791870117
179,3738,5442,1704,821,6.25300407409668,1.544952392578125,5.847930908203125,4.189014434814453,8.353948593139648
180,1939,9525,7586,3985,42.05679893493652,4.067897796630859,39.3218994140625,27.361154556274414,54.86798286437988
181,752,9617,8865,3588,38.31791877746582,3.7751197814941406,34.25288200378418,26.515960693359375,52.159786224365234
182,1663,5457,3794,63,0.3001689910888672,0.8027553558349609,0.22602081298828125,0.1659393310546875,0.45990943908691406
183,248,618,370,1001,10.170221328735352,0.8060932159423828,7.942914962768555,5.946159362792969,12.073040008544922
184,3062,3791,729,3752,37.90783882141113,3.475189208984375,39.42084312438965,26.466846466064453,51.902055740356445
185,4453,8254,3801,2408,25.08091926574707,3.2548904418945312,22.7048397064209,14.951944351196289,28.915882110595703
186,2645,7559,4914,4995,50.19712448120117,4.432916641235352,49.26490783691406,36.69404983520508,67.10314750671387
187,1566,3328,1762,1977,17.530202865600586,1.7199516296386719,15.996932983398438,11.96599006652832,22.01700210571289
188,169,9077,8908,2528,23.185253143310547,3.004789352416992,22.300004959106445,15.98501205444336,30.514955520629883
189,5484,6621,1137,2016,18.568038940429688,2.287149429321289,17.784833908081055,12.037038803100586,23.475170135498047
190,3498,6543,3045,3339,31.51392936706543,3.144979476928711,30.050039291381836,25.166749954223633,45.11713981628418
191,599,3281,2682,1601,13.910055160522461,1.5082359313964844,13.766050338745117,9.143829345703125,17.91524887084961
192,1018,7811,6793,1903,17.246007919311523,2.402067184448242,16.01886749267578,11.243820190429688,22.050142288208008
193,1951,6401,4450,4652,49.04294013977051,4.415035247802734,47.705888748168945,34.43193435668945,62.42489814758301
194,5018,5404,386,1959,17.742156982421875,2.777099609375,18.985986709594727,11.014938354492188,22.970199584960938
195,6088,9971,3883,298,1.8718242645263672,1.6329288482666016,1.7578601837158203,1.1479854583740234,2.627134323120117
196,275,8441,8166,4743,46.878814697265625,4.3010711669921875,47.53613471984863,34.83700752258301,65.55891036987305
197,7695,8774,1079,3905,38.23208808898926,3.7796497344970703,36.585092544555664,25.542020797729492,51.9258975982666
198,948,2278,1330,3383,32.37175941467285,2.4449825286865234,29.77895736694336,21.575927734375,45.39084434509277
199,1534,7102,5568,1804,16.376972198486328,2.2881031036376953,16.611099243164062,10.711669921875,23.647069931030273
200,235,2079,1844,2644,24.65510368347168,1.9845962524414062,26.38697624206543,16.495704650878906,32.30094909667969
201,1800,8718,6918,1899,18.594026565551758,2.6979446411132812,16.726016998291016,11.34634017944336,22.660017013549805
202,3930,3939,9,4771,49.494028091430664,3.8797855377197266,34.49606895446777,22.767066955566406,57.50703811645508
203,2696,3850,1154,437,2.9571056365966797,0.8540153503417969,3.155946731567383,1.8210411071777344,4.112958908081055
204,2160,5887,3727,952,7.700204849243164,1.4979839324951172,7.049798965454102,4.912137985229492,9.97304916381836
205,6511,6972,461,1712,16.5560245513916,2.177000045776367,14.046907424926758,10.724067687988281,20.18117904663086
206,4831,9364,4533,1761,15.670061111450195,2.5949478149414062,16.5708065032959,10.730981826782227,20.457983016967773
207,3356,5713,2357,4148,43.737173080444336,3.4952163696289062,40.50922393798828,30.282974243164062,53.674936294555664
208,1138,8721,7583,4862,49.402713775634766,4.49371337890625,50.17685890197754,35.1560115814209,63.021183013916016
209,983,1990,1007,2061,18.61119270324707,1.5690326690673828,18.60976219177246,12.695789337158203,24.67203140258789
210,1106,3664,2558,1156,9.956836700439453,1.2869834899902344,8.605003356933594,6.38270378112793,12.436866760253906
211,445,3029,2584,4101,42.18125343322754,3.1991004943847656,38.909912109375,30.149221420288086,57.47723579406738
212,5465,6852,1387,3347,34.94596481323242,3.1757354736328125,29.44803237915039,22.702932357788086,42.97614097595215
213,6804,6884,80,4475,44.403076171875,3.917217254638672,38.58613967895508,23.752927780151367,60.774803161621094
214,174,8295,8121,3771,36.76486015319824,3.7407875061035156,39.44110870361328,25.974035263061523,49.870967864990234
215,4258,5196,938,4662,48.364877700805664,3.6308765411376953,44.523000717163086,31.917810440063477,62.943220138549805
216,2784,2787,3,4932,50.33397674560547,3.8809776306152344,49.44634437561035,30.66396713256836,52.25014686584473
217,2328,2831,503,4601,57.59835243225098,5.644083023071289,51.68318748474121,34.2562198638916,91.73083305358887
218,3755,5913,2158,3774,70.10197639465332,7.5588226318359375,56.81896209716797,39.23201560974121,56.652069091796875
219,4407,7733,3326,4987,52.92701721191406,4.805803298950195,49.67784881591797,35.64000129699707,69.89598274230957
220,112,7447,7335,2262,20.586013793945312,2.721071243286133,20.45917510986328,13.792991638183594,27.45795249938965
221,46,4260,4214,2662,24.937868118286133,2.338886260986328,25.8481502532959,16.958951950073242,32.57584571838379
222,2164,7911,5747,866,8.402347564697266,2.048969268798828,6.826877593994141,4.435062408447266,8.950233459472656
223,2638,4759,2121,1230,10.544300079345703,1.5039443969726562,9.865045547485352,6.731748580932617,13.319253921508789
224,1653,9467,7814,1859,16.499757766723633,2.6607513427734375,17.230987548828125,12.059926986694336,22.011280059814453
225,153,9202,9049,2853,26.695966720581055,3.8661956787109375,28.92899513244629,19.59514617919922,36.67187690734863
226,5217,9180,3963,4943,50.73404312133789,4.839897155761719,55.21392822265625,37.927865982055664,69.16499137878418
227,1805,8873,7068,3004,28.182029724121094,3.2639503479003906,26.658058166503906,19.615888595581055,39.29901123046875
228,7337,9231,1894,2591,24.03092384338379,2.977132797241211,21.960973739624023,16.885995864868164,34.05117988586426
229,3712,9773,6061,3324,32.73320198059082,3.6630630493164062,29.54888343811035,22.521018981933594,41.75424575805664
230,3395,3416,21,338,2.2878646850585938,0.6940364837646484,1.6031265258789062,1.1661052703857422,2.8002262115478516
231,6232,6709,477,92,0.4608631134033203,1.0187625885009766,0.3490447998046875,0.2498626708984375,0.5791187286376953
232,265,6464,6199,164,0.8971691131591797,1.0259151458740234,0.8308887481689453,0.5209445953369141,1.1970996856689453
233,3407,6246,2839,2602,25.418996810913086,2.567291259765625,23.534059524536133,16.372203826904297,31.467914581298828
234,2012,8408,6396,1493,12.688159942626953,2.276182174682617,12.538909912109375,8.749961853027344,16.806840896606445
235,3535,4543,1008,2484,24.074077606201172,2.3658275604248047,21.51775360107422,14.999151229858398,31.356334686279297
236,2811,9239,6428,2581,25.495052337646484,3.4830570220947266,22.794008255004883,16.764163970947266,31.414031982421875
237,505,8359,7854,1272,10.771989822387695,2.1119117736816406,10.077953338623047,7.168054580688477,18.39303970336914
238,6925,7653,728,3509,37.95218467712402,4.214048385620117,34.56306457519531,26.072025299072266,46.67305946350098
239,673,1669,996,2516,25.421142578125,1.9011497497558594,20.81775665283203,16.69001579284668,30.896902084350586
240,5780,5921,141,4862,50.85492134094238,4.36091423034668,41.857004165649414,27.91285514831543,68.27783584594727
241,2424,8616,6192,2196,20.992040634155273,4.057168960571289,19.199848175048828,15.542984008789062,32.11331367492676
242,3195,3413,218,649,5.583286285400391,0.9717941284179688,4.210233688354492,3.0241012573242188,6.435871124267578
243,7864,9251,1387,3873,38.25783729553223,4.85682487487793,37.008047103881836,27.132749557495117,52.577972412109375
244,110,2131,2021,2756,26.503801345825195,2.176046371459961,26.710033416748047,17.33708381652832,34.268856048583984
245,3857,7966,4109,2354,22.320270538330078,2.7010440826416016,22.2928524017334,16.475915908813477,29.80804443359375
246,3011,5199,2188,429,2.8960704803466797,1.0919570922851562,3.1859874725341797,2.8290748596191406,3.856182098388672
247,3408,4357,949,634,4.664897918701172,1.024007797241211,4.490137100219727,3.122091293334961,6.124973297119141
248,670,8834,8164,4959,53.395986557006836,4.562854766845703,54.36110496520996,37.38212585449219,74.56612586975098
249,5574,8794,3220,4142,44.447898864746094,4.071950912475586,40.47679901123047,28.45287322998047,56.321144104003906
250,1642,9632,7990,3319,32.366037368774414,3.5791397094726562,30.315876007080078,22.079944610595703,39.81971740722656
251,1771,5126,3355,1991,17.6241397857666,2.034902572631836,16.217708587646484,12.258052825927734,25.235891342163086
252,621,7558,6937,2109,18.896102905273438,2.538919448852539,18.545866012573242,12.750625610351562,24.631977081298828
253,880,3071,2191,1638,14.770269393920898,1.558065414428711,13.235807418823242,9.846210479736328,18.653392791748047
254,724,4124,3400,656,4.853963851928711,1.1856555938720703,4.551887512207031,3.1659603118896484,6.457090377807617
255,1807,7511,5704,789,6.273984909057617,1.628875732421875,9.304046630859375,4.149913787841797,8.575201034545898
256,7086,9681,2595,2729,26.262998580932617,3.85284423828125,26.937007904052734,18.880844116210938,36.164045333862305
257,3003,6817,3814,3184,34.76524353027344,3.6017894744873047,35.652875900268555,23.32282066345215,44.921875
258,1545,6280,4735,1227,11.489152908325195,1.9161701202392578,10.929107666015625,7.338047027587891,14.499902725219727
259,433,6540,6107,696,5.303144454956055,1.7290115356445312,5.22923469543457,4.084110260009766,7.167816162109375
260,4479,7415,2936,1312,14.528036117553711,2.006053924560547,11.347055435180664,7.153987884521484,15.679121017456055
261,2730,4523,1793,20,0.08487701416015625,0.7128715515136719,0.05817413330078125,0.03910064697265625,0.09012222290039062
262,1877,7245,5368,3949,45.32194137573242,3.92913818359375,48.249006271362305,38.35010528564453,69.7321891784668
263,2215,7951,5736,3463,37.74738311767578,3.625154495239258,35.88080406188965,22.52793312072754,44.055938720703125
264,6714,7170,456,2666,24.377107620239258,2.727031707763672,23.80084991455078,15.59901237487793,32.92417526245117
265,2181,4954,2773,3890,39.36886787414551,3.2219886779785156,38.04731369018555,26.85093879699707,51.193952560424805
266,1468,4276,2808,3805,37.65702247619629,3.2546520233154297,37.52708435058594,29.991865158081055,54.48293685913086
267,2866,8242,5376,3272,35.60185432434082,6.494998931884766,38.93089294433594,25.843143463134766,44.883012771606445
268,515,4419,3904,4212,46.89216613769531,3.8568973541259766,55.732011795043945,33.07819366455078,54.84127998352051
269,699,6754,6055,3953,38.301944732666016,3.551006317138672,39.44277763366699,26.58700942993164,50.77004432678223
270,2566,6415,3849,2333,20.869016647338867,2.481222152709961,20.426034927368164,14.747142791748047,27.78482437133789
271,4409,7185,2776,4848,47.86205291748047,4.075765609741211,46.20528221130371,36.128997802734375,63.01999092102051
272,4902,9453,4551,171,0.9560585021972656,1.4500617980957031,0.7998943328857422,0.5838871002197266,1.2929439544677734
273,1462,8421,6959,2714,27.71306037902832,3.1909942626953125,24.550914764404297,17.382144927978516,32.9742431640625
274,1355,5119,3764,3427,32.49692916870117,2.9249191284179688,36.1790657043457,22.034168243408203,44.0671443939209
275,1472,9376,7904,202,1.2927055358886719,1.4781951904296875,0.9448528289794922,0.7739067077636719,1.5311241149902344
276,1803,2782,979,1196,9.87696647644043,1.1577606201171875,9.474039077758789,6.677150726318359,12.916803359985352
277,392,9954,9562,4907,48.52414131164551,4.668951034545898,50.63199996948242,38.110971450805664,68.06707382202148
278,927,4267,3340,3798,39.62302207946777,3.019094467163086,34.50274467468262,25.482892990112305,48.19011688232422
279,234,1563,1329,4694,46.097755432128906,3.145933151245117,46.98300361633301,31.095027923583984,64.03613090515137
280,4186,8278,4092,1235,10.186910629272461,2.006053924560547,9.829998016357422,6.6928863525390625,13.286352157592773
281,1366,2733,1367,2167,19.43182945251465,1.7490386962890625,17.602920532226562,12.93802261352539,25.411128997802734
282,2241,6045,3804,1362,11.883974075317383,1.7867088317871094,11.771917343139648,7.534980773925781,14.941215515136719
283,805,7628,6823,4977,49.3772029876709,4.302024841308594,49.59297180175781,34.90781784057617,69.23913955688477
284,2369,8693,6324,2426,21.85797691345215,2.869129180908203,22.04608917236328,15.064001083374023,29.057979583740234
285,3956,8042,4086,914,7.081031799316406,1.7690658569335938,6.9561004638671875,4.783868789672852,9.318113327026367
286,5533,6187,654,549,3.8979053497314453,1.219034194946289,3.5467147827148438,2.4559497833251953,5.131006240844727
287,5556,8592,3036,4331,44.73614692687988,4.172801971435547,46.26321792602539,31.641244888305664,61.591148376464844
288,3183,6619,3436,4256,45.902252197265625,4.019975662231445,40.45581817626953,28.75232696533203,55.15599250793457
289,7453,8312,859,3165,29.561758041381836,3.1468868255615234,28.06878089904785,19.588708877563477,42.04297065734863
290,6997,8342,1345,4539,44.56019401550293,4.024744033813477,46.84114456176758,30.39407730102539,60.55021286010742
291,1853,9383,7530,1888,16.53289794921875,2.6111602783203125,17.454147338867188,11.071920394897461,21.624088287353516
292,1792,9583,7791,1345,11.174917221069336,2.302885055541992,10.526895523071289,7.592916488647461,13.952016830444336
293,1895,9049,7154,3809,36.341190338134766,3.7860870361328125,35.809993743896484,26.519775390625,51.152944564819336
294,5712,9979,4267,2385,21.46601676940918,2.969026565551758,21.9881534576416,15.729188919067383,30.779123306274414
295,1161,4702,3541,1106,9.900093078613281,1.5401840209960938,9.234905242919922,6.337165832519531,12.27116584777832
296,7449,9196,1747,2172,19.368886947631836,2.6848316192626953,19.54197883605957,14.003753662109375,25.949954986572266
297,1200,2688,1488,3603,34.26408767700195,3.641843795776367,36.226749420166016,23.2088565826416,45.555830001831055
298,87,8337,8250,3812,36.4537239074707,3.72314453125,38.42592239379883,25.584936141967773,48.46692085266113
299,1182,6497,5315,3539,33.635854721069336,3.229856491088867,33.14685821533203,23.32592010498047,44.464111328125
300,7405,9833,2428,1530,12.877702713012695,2.3910999298095703,12.8631591796875,8.683919906616211,17.241716384887695
301,7166,9945,2779,4359,42.43874549865723,4.484891891479492,42.53077507019043,29.19602394104004,56.84304237365723
302,2594,2769,175,4395,43.15304756164551,3.052949905395508,35.89797019958496,25.194883346557617,57.311058044433594
303,3974,9840,5866,4159,40.3139591217041,4.117012023925781,46.03385925292969,30.854225158691406,55.001258850097656
304,5734,7207,1473,1580,13.45515251159668,2.048015594482422,13.029098510742188,8.901834487915039,17.763853073120117
305,11,4833,4822,986,7.755041122436523,1.3761520385742188,7.494926452636719,5.18798828125,10.159969329833984
306,4947,5275,328,2895,28.58114242553711,2.9671192169189453,24.26290512084961,16.719818115234375,35.61592102050781
307,3953,3956,3,482,3.3168792724609375,0.8440017700195312,2.3000240325927734,1.2180805206298828,3.0519962310791016
308,2354,3259,905,2367,21.312952041625977,1.936197280883789,19.8209285736084,14.139890670776367,28.138160705566406
309,5912,6219,307,2011,17.683982849121094,2.1140575408935547,17.5631046295166,11.02590560913086,23.32901954650879
310,2872,6710,3838,4071,39.30807113647461,3.56292724609375,39.54601287841797,28.07021141052246,52.16789245605469
311,2165,3611,1446,1290,10.617971420288086,1.332998275756836,9.514093399047852,6.927251815795898,14.010906219482422
312,105,8919,8814,2804,25.809288024902344,3.159046173095703,25.522947311401367,17.795085906982422,36.24606132507324
313,101,6342,6241,1924,17.448902130126953,2.207040786743164,16.509056091308594,11.584043502807617,21.020889282226562
314,695,4917,4222,34,0.14090538024902344,0.6918907165527344,0.1049041748046875,0.06818771362304688,0.16427040100097656
315,32,33,1,2138,16.178131103515625,1.1429786682128906,12.003898620605469,6.151914596557617,3.6699771881103516
316,3619,8872,5253,4741,46.92888259887695,4.3468475341796875,50.55499076843262,37.531137466430664,62.73603439331055
317,6261,6630,369,2494,22.716999053955078,2.4819374084472656,22.045135498046875,14.072179794311523,30.111074447631836
318,7372,8283,911,4887,53.835153579711914,4.744052886962891,44.682979583740234,31.91518783569336,64.40210342407227
319,3321,6475,3154,2267,20.294904708862305,2.439260482788086,22.003889083862305,16.10398292541504,27.363061904907227
320,5373,8441,3068,2650,24.312973022460938,2.9249191284179688,25.16913414001465,16.498327255249023,32.68790245056152
321,973,3385,2412,1126,9.048700332641602,1.2121200561523438,9.330034255981445,6.075859069824219,11.948108673095703
322,1523,1622,99,1426,12.052059173583984,1.0857582092285156,9.817123413085938,6.932973861694336,15.640735626220703
323,4725,8753,4028,1204,9.868860244750977,2.0530223846435547,9.60397720336914,6.653070449829102,14.254093170166016
324,3301,5056,1755,224,1.3887882232666016,0.9031295776367188,1.3277530670166016,0.8890628814697266,1.7299652099609375
325,4998,8566,3568,4616,45.50790786743164,4.373073577880859,43.122053146362305,31.486034393310547,60.20998954772949
326,2168,7311,5143,402,2.647876739501953,1.3217926025390625,2.4290084838867188,1.692056655883789,3.5293102264404297
327,8272,9198,926,1996,17.528057098388672,2.6051998138427734,15.782833099365234,13.63682746887207,24.498939514160156
328,6336,7112,776,2485,23.331165313720703,2.5610923767089844,20.708084106445312,14.828681945800781,33.01715850830078
329,54,5176,5122,4808,51.52297019958496,3.8461685180664062,47.061920166015625,36.48519515991211,63.078880310058594
330,7196,8998,1802,280,1.7199516296386719,1.486063003540039,1.5010833740234375,1.069784164428711,2.287149429321289
331,1512,9460,7948,2414,21.98481559753418,3.055095672607422,21.923065185546875,14.87112045288086,28.86795997619629
332,895,5744,4849,4026,39.0782356262207,3.4151077270507812,43.01309585571289,27.074098587036133,51.596641540527344
333,2974,7945,4971,1717,14.868021011352539,2.767801284790039,15.796899795532227,9.896993637084961,19.621849060058594
334,5600,8250,2650,3656,35.092830657958984,3.486156463623047,36.23199462890625,26.360750198364258,45.001983642578125
335,1047,3071,2024,2025,18.110036849975586,1.73187255859375,19.122838973999023,12.09402084350586,23.499011993408203
336,4717,9875,5158,2101,18.950939178466797,2.8009414672851562,17.563819885253906,12.703895568847656,25.402069091796875
337,4169,7620,3451,4396,45.60208320617676,3.898143768310547,45.603036880493164,29.942035675048828,61.58900260925293
338,4493,9882,5389,383,2.6481151580810547,1.728057861328125,2.4118423461914062,1.6012191772460938,3.339052200317383
339,1897,7291,5394,160,0.8840560913085938,1.1150836944580078,0.7498264312744141,0.5121231079101562,1.1670589447021484
340,987,2770,1783,2331,21.201133728027344,1.8510818481445312,22.14336395263672,14.371871948242188,27.522802352905273
341,594,5952,5358,4778,48.15483093261719,4.463672637939453,49.67379570007324,32.96208381652832,62.67976760864258
342,5412,8835,3423,4053,44.0671443939209,3.898143768310547,39.40391540527344,27.56810188293457,51.80478096008301
343,1866,9772,7906,2613,28.49888801574707,3.4570693969726562,23.091793060302734,16.536951065063477,31.500816345214844
344,1861,7641,5780,4636,46.52690887451172,4.173040390014648,49.15595054626465,35.7210636138916,62.146902084350586
345,6087,9442,3355,1171,9.57179069519043,2.2230148315429688,8.638143539428711,6.3228607177734375,12.530088424682617
346,1596,4844,3248,2249,20.961761474609375,2.454996109008789,23.427963256835938,14.335870742797852,29.52408790588379
347,7625,8288,663,2584,24.7039794921875,2.86102294921875,23.38385581970215,18.583059310913086,31.96120262145996
348,1724,6612,4888,4894,50.16613006591797,4.081010818481445,47.52397537231445,36.48209571838379,64.70775604248047
349,986,1829,843,4423,43.897151947021484,3.000020980834961,43.00427436828613,28.444290161132812,63.79580497741699
350,7320,8959,1639,1946,17.273902893066406,2.5098323822021484,15.522003173828125,11.417865753173828,23.082971572875977
351,4595,6118,1523,3855,37.90903091430664,3.3190250396728516,37.062883377075195,25.269031524658203,49.87001419067383
352,1151,2536,1385,2638,24.361848831176758,2.020120620727539,23.0557918548584,16.267061233520508,32.35006332397461
353,7147,8507,1360,2419,21.794795989990234,2.7260780334472656,23.591279983520508,15.130043029785156,29.020071029663086
354,5204,5634,430,258,1.5728473663330078,0.9810924530029297,1.4238357543945312,0.9641647338867188,2.0639896392822266
355,123,6245,6122,3101,28.95331382751465,2.9571056365966797,30.896902084350586,21.106958389282227,44.57402229309082
356,2611,5971,3360,507,4.0130615234375,1.2960433959960938,3.6699771881103516,2.6209354400634766,5.117893218994141
357,492,9170,8678,1588,17.99178123474121,2.6988983154296875,14.821052551269531,9.61613655090332,18.609046936035156
358,8349,9882,1533,957,7.600069046020508,2.0258426666259766,7.024049758911133,4.905939102172852,9.966850280761719
359,367,7600,7233,3560,33.881187438964844,3.450155258178711,34.38997268676758,24.21402931213379,44.799089431762695
360,478,5072,4594,4047,40.35615921020508,3.3218860626220703,39.08705711364746,27.013063430786133,51.89204216003418
361,247,7620,7373,2674,24.847984313964844,2.9420852661132812,24.898052215576172,16.911029815673828,32.22298622131348
362,1491,2002,511,1864,16.609668731689453,1.7399787902832031,15.890836715698242,10.465860366821289,21.426916122436523
363,112,1588,1476,2822,25.94470977783203,1.97601318359375,25.574922561645508,19.076108932495117,34.50584411621094
364,2044,4185,2141,1197,9.801864624023438,1.4641284942626953,9.86790657043457,6.396055221557617,12.793779373168945
365,10,6775,6765,3970,38.37013244628906,3.6039352416992188,46.527862548828125,29.620885848999023,51.052093505859375
366,6282,9235,2953,33,0.1380443572998047,1.329183578491211,0.10585784912109375,0.0629425048828125,0.1590251922607422
367,1783,7421,5638,2855,26.17192268371582,2.9439926147460938,26.50308609008789,22.144794464111328,37.80198097229004
368,4636,7058,2422,4495,47.26409912109375,3.924846649169922,45.36294937133789,33.48422050476074,58.71391296386719
369,3531,7216,3685,1876,16.36195182800293,2.3238658905029297,16.722917556762695,10.928153991699219,21.58975601196289
370,1245,6757,5512,3400,33.0510139465332,3.181934356689453,31.779050827026367,22.39084243774414,42.756080627441406
371,497,3081,2584,3623,34.47699546813965,2.732992172241211,34.4390869140625,23.926973342895508,47.660112380981445
372,5477,7489,2012,1435,12.011051177978516,1.9917488098144531,12.000083923339844,8.076190948486328,15.879154205322266
373,298,5920,5622,3246,30.29012680053711,2.959012985229492,33.307790756225586,21.44598960876465,42.27423667907715
374,1417,3387,1970,3898,37.457942962646484,3.0798912048339844,39.33072090148926,25.7720947265625,49.716949462890625
375,5717,7510,1793,313,1.9788742065429688,1.260995864868164,1.6541481018066406,1.2199878692626953,2.6369094848632812
376,1748,4093,2345,4982,49.340009689331055,3.693819046020508,50.76885223388672,34.503936767578125,66.67399406433105
377,554,9200,8646,4628,47.477006912231445,4.355907440185547,48.19202423095703,31.739234924316406,61.89084053039551
378,4869,7705,2836,2282,20.49088478088379,2.5627613067626953,20.42222023010254,13.972997665405273,27.021169662475586
379,1337,2064,727,3307,31.282901763916016,2.346038818359375,27.917146682739258,20.146846771240234,41.432857513427734
380,2572,5754,3182,3602,34.96408462524414,3.1321048736572266,34.52801704406738,23.663043975830078,45.333147048950195
381,3779,7624,3845,2166,19.147872924804688,2.51007080078125,18.192052841186523,13.220071792602539,25.34794807434082
382,6242,8638,2396,3540,33.429861068725586,3.4661293029785156,33.87117385864258,23.015975952148438,44.35920715332031
383,1056,2740,1684,660,5.114078521728516,0.8349418640136719,4.422903060913086,3.167867660522461,6.355047225952148
384,2056,3398,1342,1315,10.831117630004883,1.3170242309570312,9.68790054321289,7.252216339111328,14.415979385375977
385,4207,4413,206,1154,9.263753890991211,1.3320446014404297,7.719993591308594,6.879091262817383,13.401031494140625
386,6969,9431,2462,2572,25.446176528930664,2.9859542846679688,21.98195457458496,16.835689544677734,35.523176193237305
387,232,2692,2460,701,5.28407096862793,0.8420944213867188,4.653215408325195,3.452777862548828,6.897926330566406
388,4355,5948,1593,599,4.280805587768555,1.2259483337402344,4.0531158447265625,2.7599334716796875,5.709648132324219
389,2782,3459,677,2655,24.225950241088867,2.1829605102539062,22.52984046936035,15.995264053344727,34.59620475769043
390,7592,9029,1437,2094,20.769119262695312,3.3495426177978516,18.844127655029297,12.484073638916016,24.447917938232422
391,4865,5540,675,1262,10.3759765625,1.583099365234375,9.549617767333984,6.6699981689453125,16.427993774414062
392,4401,9305,4904,917,7.478952407836914,1.9612312316894531,7.224082946777344,4.740715026855469,9.321928024291992
393,2386,5224,2838,1193,9.670257568359375,1.5139579772949219,10.07533073425293,6.505012512207031,12.782096862792969
394,4570,7395,2825,3637,37.28914260864258,3.5011768341064453,41.10002517700195,25.631427764892578,52.11997032165527
395,695,4853,4158,3527,38.45977783203125,2.980947494506836,33.22911262512207,23.03004264831543,44.335126876831055
396,4602,6601,1999,469,3.2150745391845703,1.2459754943847656,3.0558109283447266,2.0890235900878906,4.242181777954102
397,1730,7197,5467,2300,20.672082901000977,2.7883052825927734,20.136117935180664,14.340877532958984,26.515960693359375
398,1499,6515,5016,1805,17.9901123046875,2.1250247955322266,15.214204788208008,10.661125183105469,20.58887481689453
399,231,9857,9626,2211,19.66571807861328,2.9189586639404297,19.276142120361328,13.365745544433594,29.095172882080078
400,5302,8832,3530,2353,23.8800048828125,3.197908401489258,22.800922393798828,14.886856079101562,31.973838806152344
401,1013,5363,4350,3003,31.641244888305664,2.891063690185547,27.369976043701172,19.22321319580078,39.704084396362305
402,1390,3621,2231,1950,17.02713966369629,1.7681121826171875,15.63405990600586,11.420011520385742,22.619962692260742
403,5366,8499,3133,1847,16.01886749267578,2.49481201171875,16.539812088012695,10.914802551269531,23.58698844909668
404,1235,8037,6802,4588,44.82102394104004,4.122018814086914,45.781850814819336,33.26106071472168,62.12925910949707
405,3550,8000,4450,354,2.295970916748047,1.3790130615234375,1.9958019256591797,1.4820098876953125,3.033161163330078
406,7230,9110,1880,2042,17.98105239868164,2.583026885986328,18.734216690063477,12.215137481689453,23.822784423828125
407,4429,5260,831,3233,31.084060668945312,2.759218215942383,28.849124908447266,19.845008850097656,42.21987724304199
408,2128,6950,4822,2748,25.32482147216797,2.7930736541748047,24.71184730529785,17.262935638427734,33.54692459106445
409,2062,5979,3917,4947,49.002885818481445,4.302978515625,47.92380332946777,35.4459285736084,71.00510597229004
410,4190,9014,4824,2595,27.203083038330078,3.3648014068603516,24.483919143676758,16.284942626953125,31.422138214111328
411,1475,1856,381,1652,14.111995697021484,1.2726783752441406,13.390064239501953,9.034872055053711,18.548965454101562
412,6464,6554,90,3391,34.758806228637695,3.301858901977539,26.04079246520996,17.664194107055664,42.56796836853027
413,7069,7501,432,2147,19.032001495361328,2.454042434692383,17.8530216217041,12.007951736450195,25.264978408813477
414,1334,4626,3292,2566,23.31399917602539,2.317667007446289,24.552106857299805,16.16191864013672,34.49225425720215
415,1151,4751,3600,4273,45.21918296813965,4.019975662231445,43.649911880493164,31.72588348388672,54.90827560424805
416,1413,4227,2814,4179,40.55595397949219,3.2529830932617188,42.87123680114746,27.68707275390625,54.02112007141113
417,45,2817,2772,4468,44.950008392333984,3.2269954681396484,46.25511169433594,32.65690803527832,61.44261360168457
418,7101,7468,367,3895,39.72601890563965,3.4761428833007812,36.80729866027832,23.600101470947266,47.208309173583984
419,3335,7612,4277,4781,46.994924545288086,4.1522979736328125,46.340227127075195,32.90915489196777,62.45303153991699
420,3850,9190,5340,1947,17.012834548950195,2.599954605102539,17.97628402709961,13.135910034179688,22.38607406616211
421,1669,6565,4896,1076,8.555173873901367,1.6961097717285156,8.260250091552734,5.558013916015625,14.299154281616211
422,2213,9873,7660,3619,34.30509567260742,3.7927627563476562,36.04412078857422,24.13177490234375,45.764923095703125
423,2654,9153,6499,3539,33.58101844787598,3.635883331298828,34.07788276672363,23.11110496520996,44.60501670837402
424,4612,9118,4506,4724,46.29993438720703,4.297971725463867,45.53985595703125,32.24301338195801,62.12425231933594
425,3818,5674,1856,1464,12.938976287841797,1.9028186798095703,14.622926712036133,8.167028427124023,19.950151443481445
426,1753,7114,5361,3279,35.20011901855469,3.161191940307617,31.906843185424805,21.337270736694336,41.181325912475586
427,3551,3622,71,4474,43.97273063659668,4.273891448974609,38.27810287475586,23.452043533325195,59.76223945617676
428,5654,6121,467,3287,30.92479705810547,2.8870105743408203,27.410268783569336,19.73700523376465,43.51067543029785
429,1494,4971,3477,4615,46.762943267822266,3.629922866821289,47.93381690979004,34.74283218383789,66.64085388183594
430,3818,4888,1070,149,1.013040542602539,0.7882118225097656,0.8270740509033203,0.5159378051757812,1.1980533599853516
431,5956,9254,3298,886,8.993864059448242,2.0051002502441406,6.2961578369140625,5.335807800292969,10.13493537902832
432,1960,3584,1624,4984,56.565046310424805,4.407167434692383,55.42612075805664,41.023969650268555,74.73921775817871
433,1037,9196,8159,519,3.7658214569091797,1.7268657684326172,3.6869049072265625,2.6390552520751953,4.906892776489258
434,3035,3990,955,2328,22.613048553466797,2.6209354400634766,23.519039154052734,15.002250671386719,28.591156005859375
435,813,2846,2033,4857,51.302194595336914,3.442049026489258,45.69506645202637,34.693241119384766,65.01293182373047
436,4375,5643,1268,2844,28.835773468017578,2.579927444458008,25.03824234008789,17.534971237182617,36.19885444641113
437,3923,9564,5641,4419,44.70682144165039,4.200935363769531,52.100181579589844,32.531023025512695,63.121795654296875
438,2753,5902,3149,1275,12.359857559204102,3.036975860595703,10.483980178833008,8.033037185668945,16.572952270507812
439,3143,9351,6208,1651,16.144752502441406,3.3500194549560547,17.976999282836914,11.34490966796875,23.8950252532959
440,1632,4840,3208,205,3.5829544067382812,1.1677742004394531,1.31988525390625,0.8919239044189453,1.806020736694336
441,2935,6229,3294,330,2.259969711303711,1.1141300201416016,2.3469924926757812,1.3871192932128906,4.524946212768555
442,5835,5970,135,504,4.291057586669922,1.209259033203125,3.4439563751220703,2.4907588958740234,7.152318954467773
443,2830,3522,692,1466,16.300201416015625,1.827239990234375,14.09006118774414,9.97304916381836,23.375988006591797
444,206,9980,9774,1473,14.16015625,3.671884536743164,14.819145202636719,10.79702377319336,23.029088973999023
445,7347,8170,823,700,5.77092170715332,1.764059066772461,6.431102752685547,4.575014114379883,8.13603401184082
446,5731,7713,1982,2458,26.568889617919922,2.652883529663086,30.862808227539062,22.34816551208496,37.75215148925781
447,953,4461,3508,3372,40.52281379699707,2.9871463775634766,38.127899169921875,25.79474449157715,53.53498458862305
448,3635,6620,2985,1887,18.554210662841797,3.8421154022216797,20.211219787597656,12.736082077026367,25.156736373901367
449,4626,8898,4272,1547,17.43793487548828,4.291057586669922,15.872001647949219,12.184858322143555,21.13199234008789
450,5799,7524,1725,954,9.76705551147461,1.711130142211914,8.399724960327148,6.239891052246094,10.88404655456543
451,5225,8786,3561,1282,12.573003768920898,2.2890567779541016,11.250972747802734,8.352041244506836,15.439033508300781
452,5603,7778,2175,4263,48.04086685180664,3.9048194885253906,46.76008224487305,29.675960540771484,59.30209159851074
453,1636,8313,6677,3306,33.35714340209961,3.4990310668945312,32.531023025512695,21.692991256713867,41.74518585205078
454,4699,8858,4159,2179,19.81210708618164,2.6929378509521484,19.939184188842773,13.23699951171875,26.83091163635254
455,50,5834,5784,4649,45.75681686401367,3.8909912109375,48.92086982727051,35.55703163146973,69.67711448669434
456,6211,9409,3198,1988,19.00792121887207,4.357814788818359,17.602920532226562,11.78288459777832,25.251150131225586
457,6096,9391,3295,359,2.3369789123535156,1.5759468078613281,2.1240711212158203,1.4412403106689453,3.8137435913085938
458,3667,7510,3843,4141,44.42620277404785,3.871917724609375,43.46919059753418,27.747154235839844,53.36189270019531
459,514,9441,8927,4334,42.24896430969238,4.204034805297852,40.856122970581055,33.11419486999512,58.012962341308594
460,957,971,14,3099,29.725074768066406,1.9490718841552734,21.325111389160156,13.000011444091797,34.82389450073242
461,4587,9684,5097,1212,9.813070297241211,2.329111099243164,10.331869125366211,7.183074951171875,12.962102890014648
462,5631,5838,207,3311,32.28425979614258,2.8731822967529297,29.268980026245117,18.694162368774414,41.326045989990234
463,8339,9573,1234,4782,47.5621223449707,4.337072372436523,44.384002685546875,42.42396354675293,68.73917579650879
464,685,9874,9189,1866,16.356945037841797,2.698183059692383,17.030954360961914,12.52293586730957,22.902965545654297
465,146,3634,3488,709,5.5217742919921875,0.9908676147460938,5.166053771972656,3.545999526977539,6.961822509765625
466,1300,7983,6683,1747,15.391111373901367,2.3479461669921875,14.595985412597656,10.21432876586914,21.211862564086914
467,157,5789,5632,4508,44.506072998046875,3.7360191345214844,46.85473442077637,30.81989288330078,60.09411811828613
468,7505,7815,310,330,2.317190170288086,1.316070556640625,1.7390251159667969,1.3201236724853516,2.7778148651123047
469,3537,5545,2008,992,7.836103439331055,1.4269351959228516,6.997823715209961,5.032777786254883,10.251998901367188
470,7998,9505,1507,3041,28.490066528320312,3.2682418823242188,27.167081832885742,19.034862518310547,37.544965744018555
471,1053,7746,6693,850,7.884979248046875,1.9729137420654297,7.173061370849609,4.543066024780273,8.656024932861328
472,4156,9882,5726,3826,36.90910339355469,3.895998001098633,36.96298599243164,25.406837463378906,52.13427543640137
473,4195,9964,5769,2803,25.983095169067383,3.2660961151123047,24.700164794921875,17.681121826171875,35.46786308288574
474,4164,9803,5639,3824,38.6350154876709,4.046916961669922,37.53185272216797,28.544902801513672,57.533979415893555
475,2994,8978,5984,2910,28.931140899658203,3.3888816833496094,26.697874069213867,18.542766571044922,39.60394859313965
476,4057,8993,4936,2063,19.72675323486328,2.808094024658203,18.139123916625977,12.836933135986328,26.173114776611328
477,2277,3443,1166,4944,50.06599426269531,3.560781478881836,48.94304275512695,32.44519233703613,65.64903259277344
478,3063,9945,6882,1707,14.856815338134766,2.5801658630371094,14.410734176635742,10.14089584350586,19.983291625976562
479,4057,8960,4903,758,5.721092224121094,1.8031597137451172,5.3539276123046875,3.854036331176758,7.505893707275391
480,402,6701,6299,869,6.902933120727539,1.5909671783447266,6.136178970336914,4.321098327636719,8.810281753540039
481,2835,8541,5706,1770,15.358924865722656,2.3908615112304688,15.456914901733398,10.57887077331543,19.24896240234375
482,360,1683,1323,1990,19.655227661132812,1.714944839477539,16.581058502197266,11.636018753051758,23.190736770629883
483,3016,9648,6632,1911,16.691923141479492,2.6750564575195312,16.965866088867188,11.58285140991211,22.114992141723633
484,7511,8914,1403,2592,23.653268814086914,2.9561519622802734,21.94523811340332,17.37666130065918,33.247947692871094
485,1996,5418,3422,2284,20.31707763671875,2.2809505462646484,21.081924438476562,14.46390151977539,29.359817504882812
486,2427,4566,2139,331,2.113819122314453,0.8668899536132812,2.0380020141601562,1.3508796691894531,2.833843231201172
487,2383,4585,2202,3726,35.5379581451416,2.9942989349365234,33.40888023376465,24.578094482421875,47.061920166015625
488,2489,9767,7278,1621,13.786077499389648,2.496004104614258,14.02425765991211,10.506868362426758,19.51885223388672
489,4990,8456,3466,1950,18.36681365966797,2.6519298553466797,17.672061920166016,11.653900146484375,23.13709259033203
490,39,2190,2151,4872,51.444053649902344,4.13203239440918,46.530961990356445,33.186912536621094,63.88092041015625
491,641,5536,4895,1700,14.706850051879883,1.9669532775878906,13.739824295043945,12.207269668579102,21.28005027770996
492,3188,8790,5602,278,1.9631385803222656,1.6620159149169922,1.6911029815673828,1.1060237884521484,2.431154251098633
493,1001,9031,8030,321,2.045869827270508,1.5130043029785156,1.8219947814941406,1.2662410736083984,2.7170181274414062
494,7607,8028,421,1761,15.140056610107422,2.218008041381836,13.765811920166016,9.720087051391602,19.97685432434082
495,3089,9134,6045,1151,9.337902069091797,2.1059513092041016,8.495092391967773,6.105184555053711,12.265920639038086
496,3269,8440,5171,1103,8.926868438720703,1.9450187683105469,10.675191879272461,6.676912307739258,12.408018112182617
497,9011,9751,740,2686,26.710987091064453,3.069162368774414,25.638103485107422,17.270803451538086,33.8740348815918
498,6289,8277,1988,525,3.686189651489258,1.5287399291992188,3.1890869140625,2.329111099243164,4.8656463623046875
499,3633,8508,4875,3320,31.232118606567383,3.3669471740722656,29.159069061279297,21.6672420501709,41.45407676696777
500,3746,5099,1353,1084,8.621931076049805,1.4178752899169922,9.353876113891602,5.779027938842773,13.471126556396484
501,3358,4459,1101,1813,16.630172729492188,1.773834228515625,15.039920806884766,10.492801666259766,20.622968673706055
502,5737,7898,2161,2874,26.41606330871582,2.9566287994384766,25.89583396911621,18.126964569091797,33.309221267700195
503,2269,3507,1238,3785,36.222219467163086,4.711151123046875,37.03117370605469,25.287151336669922,50.21214485168457
504,8740,8957,217,1229,10.017871856689453,2.028226852416992,9.003877639770508,6.108283996582031,13.23699951171875
505,2804,4517,1713,3020,27.95267105102539,2.5479793548583984,27.84895896911621,19.127845764160156,37.47987747192383
506,7107,9291,2184,687,5.1021575927734375,1.7931461334228516,4.5719146728515625,3.2482147216796875,6.724834442138672
507,2091,6747,4656,1337,11.078834533691406,1.8439292907714844,11.098861694335938,7.467985153198242,14.606952667236328
508,1654,1768,114,731,5.898952484130859,0.7848739624023438,5.570173263549805,3.4341812133789062,7.204771041870117
509,1571,8901,7330,1516,12.814998626708984,2.318143844604492,11.883735656738281,8.622884750366211,16.885995864868164
510,4738,8239,3501,876,6.705045700073242,1.7499923706054688,6.416082382202148,4.490137100219727,8.929967880249023
511,337,2292,1955,3936,37.92309761047363,2.7899742126464844,35.51983833312988,25.780916213989258,50.846099853515625
512,497,8072,7575,210,1.2187957763671875,1.2552738189697266,1.2149810791015625,0.8051395416259766,1.6682147979736328
513,3799,3821,22,1013,8.105993270874023,1.1348724365234375,5.992889404296875,3.899097442626953,10.202169418334961
514,3821,7069,3248,1128,9.074211120605469,1.7778873443603516,9.655952453613281,6.075143814086914,11.990070343017578
515,3874,5318,1444,4492,43.653249740600586,3.555774688720703,44.56019401550293,29.747962951660156,59.517860412597656
516,6779,7589,810,2166,19.205093383789062,2.428770065307617,18.969058990478516,13.103961944580078,25.31909942626953
517,5435,8694,3259,4454,43.55311393737793,4.078865051269531,48.26807975769043,30.790328979492188,62.22701072692871
518,609,2717,2108,138,0.7491111755371094,0.46515464782714844,0.6070137023925781,0.4150867462158203,0.9562969207763672
519,829,4616,3787,2311,20.903825759887695,2.1491050720214844,23.78678321838379,14.058113098144531,27.915000915527344
520,202,7062,6860,1850,16.438007354736328,2.299070358276367,16.23702049255371,11.155128479003906,21.867036819458008
521,144,3903,3759,96,0.4868507385253906,0.6089210510253906,0.39124488830566406,0.28204917907714844,0.6220340728759766
522,1189,6842,5653,4009,39.88909721374512,3.8471221923828125,41.338205337524414,27.195215225219727,54.013967514038086
523,2711,9623,6912,2017,19.0279483795166,2.8443336486816406,18.139123916625977,12.951135635375977,22.767066955566406
524,6236,8178,1942,1678,15.299797058105469,2.4347305297851562,16.122817993164062,10.347127914428711,22.049903869628906
525,3687,7431,3744,2224,22.344112396240234,2.6330947875976562,23.458003997802734,15.411138534545898,29.41584587097168
526,3703,4660,957,1034,8.974075317382812,1.416921615600586,8.272171020507812,5.787849426269531,11.372804641723633
527,5700,9732,4032,3634,36.18597984313965,4.4460296630859375,38.100242614746094,27.456045150756836,54.28504943847656
528,1234,4758,3524,4665,54.03900146484375,4.976987838745117,55.59420585632324,37.110090255737305,93.35017204284668
529,5243,9443,4200,66,0.45490264892578125,1.7609596252441406,0.24080276489257812,0.18215179443359375,0.3840923309326172
530,1708,3478,1770,2267,33.299922943115234,2.727985382080078,31.444072723388672,18.23902130126953,32.59015083312988
531,7132,9727,2595,3639,41.990041732788086,4.148006439208984,38.29813003540039,27.15921401977539,51.89704895019531
532,4930,7493,2563,4937,54.78191375732422,6.446123123168945,54.00800704956055,37.5368595123291,75.37484169006348
533,1569,6645,5076,3909,41.27311706542969,3.6301612854003906,37.54615783691406,26.818037033081055,59.24820899963379
534,1411,8857,7446,3210,42.719125747680664,3.9911270141601562,36.98086738586426,22.975921630859375,45.25113105773926
535,2762,7705,4943,2179,24.847030639648438,5.561113357543945,22.411108016967773,17.688989639282227,30.26413917541504
536,3049,7345,4296,2156,23.115158081054688,2.6450157165527344,21.268844604492188,14.694929122924805,28.331995010375977
537,2782,6704,3922,2929,30.042171478271484,3.120899200439453,30.562162399291992,18.710851669311523,36.80586814880371
538,7394,9639,2245,2740,29.066085815429688,3.6258697509765625,25.362014770507812,17.852067947387695,34.03592109680176
539,3639,7682,4043,2501,25.182008743286133,2.7332305908203125,22.912979125976562,16.056060791015625,33.70475769042969
540,2365,2470,105,429,3.21197509765625,0.6439685821533203,2.557992935180664,1.6727447509765625,3.9339065551757812
541,9604,9875,271,355,2.276182174682617,1.6179084777832031,1.9609928131103516,1.3539791107177734,3.0379295349121094
542,7958,9867,1909,4952,54.28004264831543,4.517078399658203,53.93719673156738,33.78009796142578,68.37701797485352
543,4102,9157,5055,842,6.576061248779297,2.218008041381836,6.384849548339844,4.307985305786133,8.8348388671875
544,6455,7973,1518,3413,34.29722785949707,3.9479732513427734,35.14885902404785,22.530078887939453,42.88887977600098
545,7263,7755,492,1003,9.233951568603516,1.9021034240722656,7.629871368408203,5.069971084594727,10.6201171875
546,6633,6918,285,3149,31.2039852142334,2.9189586639404297,26.10468864440918,17.99297332763672,43.591976165771484
547,66,4027,3961,1187,9.917259216308594,1.5993118286132812,9.449958801269531,8.037805557250977,13.642072677612305
548,1514,8272,6758,391,2.584695816040039,1.444101333618164,2.608776092529297,1.6410350799560547,3.4618377685546875
549,834,8110,7276,325,2.090930938720703,1.4832019805908203,1.8932819366455078,1.2862682342529297,2.753019332885742
550,2835,7108,4273,4489,49.30615425109863,3.982067108154297,46.91290855407715,30.51590919494629,61.56110763549805
551,3722,9453,5731,559,4.0721893310546875,1.9161701202392578,3.8928985595703125,2.7170181274414062,5.568027496337891
552,372,1763,1391,1731,15.081167221069336,1.3461112976074219,14.670848846435547,10.455131530761719,21.294832229614258
553,3210,6026,2816,1605,13.831853866577148,1.9011497497558594,12.813091278076172,9.266853332519531,22.25804328918457
554,4006,7505,3499,2964,27.508974075317383,2.9692649841308594,26.89814567565918,18.97406578063965,37.01210021972656
555,3005,7195,4190,1218,10.010957717895508,1.8451213836669922,10.599374771118164,6.7119598388671875,13.226985931396484
556,2550,8432,5882,2142,19.666194915771484,2.6721954345703125,22.279977798461914,12.930870056152344,25.317907333374023
557,7412,9145,1733,4321,44.92902755737305,4.072904586791992,38.56611251831055,30.417203903198242,61.640024185180664
558,8011,9170,1159,2244,20.051956176757812,2.713918685913086,19.359111785888672,13.437032699584961,26.51810646057129
559,3778,6411,2633,2483,26.821136474609375,2.5169849395751953,21.750926971435547,17.255783081054688,30.872821807861328
560,1681,9613,7932,779,6.942987442016602,2.086162567138672,5.522966384887695,5.165815353393555,8.418083190917969
561,684,7116,6432,921,7.805824279785156,1.683950424194336,7.846832275390625,4.642248153686523,9.760141372680664
562,6261,8483,2222,3609,34.945011138916016,3.490924835205078,32.679080963134766,23.730039596557617,47.37997055053711
563,1584,1695,111,4003,40.41719436645508,2.711057662963867,33.23507308959961,21.987199783325195,52.43420600891113
564,3388,6993,3605,3898,37.47820854187012,3.47900390625,40.69805145263672,26.213884353637695,49.76320266723633
565,4697,8505,3808,2448,23.3309268951416,2.804994583129883,21.750926971435547,15.381097793579102,28.091907501220703
566,1615,8777,7162,4529,44.16370391845703,4.202127456665039,45.739173889160156,31.150102615356445,59.133052825927734
567,4376,4712,336,1838,15.950202941894531,1.7979145050048828,15.138864517211914,10.04791259765625,21.12889289855957
568,2698,8633,5935,4332,42.153120040893555,4.019021987915039,40.65895080566406,29.921770095825195,59.79585647583008
569,3462,7807,4345,82,0.40221214294433594,1.148223876953125,0.34689903259277344,0.2841949462890625,0.6389617919921875
570,1009,8374,7365,1307,11.443853378295898,2.288818359375,9.723901748657227,7.444858551025391,14.323234558105469
571,616,1436,820,1172,10.522127151489258,0.9419918060302734,8.61811637878418,6.124973297119141,12.540102005004883
572,337,1918,1581,2517,25.507211685180664,1.9538402557373047,20.819902420043945,15.288114547729492,30.34496307373047
573,7219,9088,1869,4075,39.2148494720459,3.844022750854492,40.78316688537598,28.256893157958984,52.11615562438965
574,159,1018,859,4367,42.33288764953613,2.8290748596191406,38.88678550720215,27.786970138549805,59.09395217895508
575,6284,7885,1601,2663,24.602174758911133,2.808094024658203,22.99785614013672,16.592741012573242,32.24778175354004
576,8024,8622,598,4998,49.53813552856445,4.406929016113281,48.13694953918457,31.81290626525879,67.08788871765137
577,1507,7328,5821,3545,33.89382362365723,3.35693359375,34.10983085632324,24.835824966430664,48.66194725036621
578,3639,7170,3531,1510,15.81430435180664,2.0699501037597656,12.160062789916992,11.003255844116211,20.586013793945312
579,39,9849,9810,3218,34.14297103881836,3.8449764251708984,32.9747200012207,24.38497543334961,48.34604263305664
580,2876,5491,2615,4778,56.348323822021484,4.476785659790039,56.32591247558594,35.28618812561035,67.4901008605957
581,6130,8868,2738,4763,49.46708679199219,4.312038421630859,49.42488670349121,36.91697120666504,63.58814239501953
582,6369,9617,3248,2559,25.363922119140625,3.0291080474853516,22.81022071838379,19.463062286376953,31.82816505432129
583,6149,9876,3727,3858,39.975881576538086,4.31513786315918,41.25809669494629,27.199983596801758,53.48491668701172
584,2047,3920,1873,1581,14.718055725097656,1.7840862274169922,14.171123504638672,9.705066680908203,21.090030670166016
585,231,4217,3986,1061,10.257244110107422,2.1309852600097656,11.140823364257812,8.095979690551758,16.45493507385254
586,6032,7803,1771,4640,54.27408218383789,4.619121551513672,50.73714256286621,33.76483917236328,62.91508674621582
587,2444,3039,595,1859,16.53766632080078,1.6009807586669922,18.631935119628906,10.769844055175781,23.381710052490234
588,2368,9648,7280,3267,30.87592124938965,3.5169124603271484,28.837919235229492,27.00495719909668,41.63408279418945
589,1110,5442,4332,1074,8.578777313232422,1.499176025390625,8.507251739501953,5.675077438354492,11.321067810058594
590,2739,3192,453,3332,31.503915786743164,2.5238990783691406,27.8470516204834,20.174741744995117,42.64402389526367
591,3175,5168,1993,3497,33.181190490722656,4.314184188842773,35.99715232849121,22.758960723876953,43.95604133605957
592,3308,8046,4738,3003,27.853012084960938,3.110170364379883,27.18186378479004,18.95308494567871,37.22023963928223
593,3935,8888,4953,3351,31.492233276367188,3.445863723754883,32.911062240600586,22.3391056060791,43.36380958557129
594,8921,9808,887,4954,51.371097564697266,4.638195037841797,49.513816833496094,33.16307067871094,68.46213340759277
595,1159,2701,1542,1383,11.57379150390625,1.2788772583007812,10.619163513183594,7.670879364013672,16.27206802368164
596,1253,6176,4923,2776,26.2300968170166,2.6772022247314453,24.950027465820312,17.7919864654541,35.27092933654785
597,217,4359,4142,4747,46.75102233886719,3.626108169555664,44.62885856628418,32.84192085266113,67.2597885131836
598,1907,6229,4322,3837,38.91801834106445,3.3540725708007812,37.24408149719238,25.716304779052734,51.97715759277344
599,2433,9290,6857,1477,12.450695037841797,2.343893051147461,11.99793815612793,8.33892822265625,16.366958618164062
600,348,2420,2072,4299,41.892051696777344,3.0248165130615234,43.57123374938965,29.289960861206055,55.48501014709473
601,1641,5257,3616,202,1.1641979217529297,0.8571147918701172,1.0652542114257812,0.6878376007080078,1.5430450439453125
602,5045,7011,1966,4028,38.84696960449219,3.512144088745117,39.29781913757324,28.9919376373291,55.86361885070801
603,1648,9720,8072,2448,23.782014846801758,3.2999515533447266,24.697065353393555,15.933990478515625,29.316186904907227
604,6134,9303,3169,1930,16.798973083496094,2.5930404663085938,15.655994415283203,12.565851211547852,22.79186248779297
605,3982,4304,322,3694,35.63976287841797,2.888917922973633,34.2411994934082,21.883010864257812,46.710968017578125
606,3952,8188,4236,3240,32.78827667236328,3.7331581115722656,34.7142219543457,21.218061447143555,40.19594192504883
607,5675,9139,3464,2988,30.63225746154785,3.3600330352783203,27.36210823059082,19.227266311645508,35.14695167541504
608,885,5037,4152,1081,8.753776550292969,1.4379024505615234,8.281946182250977,5.661249160766602,11.336326599121094
609,1231,5901,4670,1736,15.014886856079102,1.9791126251220703,14.41502571105957,10.154008865356445,19.728899002075195
610,1926,5974,4048,2685,24.59406852722168,2.599954605102539,24.01113510131836,16.996145248413086,32.86910057067871
611,4423,7051,2628,2796,25.85601806640625,2.7799606323242188,26.002883911132812,17.41504669189453,34.123897552490234
612,2343,7089,4746,4765,47.19185829162598,5.670785903930664,47.66392707824707,38.17892074584961,66.77913665771484
613,4991,8652,3661,4848,47.9578971862793,4.29224967956543,47.837018966674805,33.04910659790039,64.04399871826172
614,7092,8350,1258,2135,20.001888275146484,2.5429725646972656,18.27096939086914,12.581110000610352,24.93882179260254
615,46,8661,8615,1916,16.66998863220215,2.560138702392578,16.72816276550293,11.316061019897461,22.066831588745117
616,171,8524,8353,4311,44.257164001464844,5.01704216003418,42.395830154418945,29.680967330932617,56.012868881225586
617,4710,9278,4568,4622,45.26400566101074,4.353046417236328,46.199798583984375,32.785892486572266,60.356855392456055
618,2373,3864,1491,731,5.489826202392578,1.02996826171875,5.661964416503906,3.621816635131836,7.261037826538086
619,4685,9214,4529,4735,46.640872955322266,4.371166229248047,52.48117446899414,34.73305702209473,63.00020217895508
620,1085,5215,4130,1387,11.586189270019531,1.6717910766601562,11.506795883178711,7.987022399902344,15.314817428588867
621,3622,4317,695,3318,31.378984451293945,2.682924270629883,28.060197830200195,20.298004150390625,41.60904884338379
622,6724,7520,796,85,0.4248619079589844,1.1248588562011719,0.32591819763183594,0.23126602172851562,0.5388259887695312
623,1576,9183,7607,4990,49.38507080078125,4.5719146728515625,54.23307418823242,36.53287887573242,65.6740665435791
624,1464,6156,4692,2704,24.78504180908203,2.6590824127197266,25.87604522705078,17.163753509521484,33.48517417907715
625,3780,8399,4619,3833,36.75484657287598,3.7078857421875,36.949872970581055,25.311946868896484,48.787832260131836
626,209,9219,9010,1572,13.222932815551758,2.424955368041992,15.803337097167969,8.97526741027832,17.638206481933594
627,3362,9953,6591,2707,25.14195442199707,3.227710723876953,24.605989456176758,16.954898834228516,32.97710418701172
628,2907,3834,927,4425,43.38788986206055,3.2808780670166016,42.814016342163086,30.693769454956055,59.18693542480469
629,4799,6464,1665,2060,19.165992736816406,2.237081527709961,17.663002014160156,12.855052947998047,25.346755981445312
630,5209,6085,876,1276,10.654926300048828,1.6658306121826172,9.345054626464844,6.780862808227539,13.781070709228516
631,5169,9961,4792,4111,39.82186317443848,4.148960113525391,39.88909721374512,27.703046798706055,53.14803123474121
632,1186,5031,3845,3620,34.60216522216797,3.0400753021240234,36.18502616882324,27.033090591430664,46.1118221282959
633,3683,3985,302,4536,44.49605941772461,4.168987274169922,40.20524024963379,27.324914932250977,58.94589424133301
634,1631,6206,4575,3960,38.0558967590332,3.427743911743164,39.24202919006348,27.235031127929688,52.490949630737305
635,5706,7501,1795,529,4.342079162597656,1.6579627990722656,3.610849380493164,2.4530887603759766,4.911899566650391
636,2135,7775,5640,4620,45.08185386657715,4.187822341918945,51.70106887817383,34.44194793701172,70.94383239746094
637,5490,9883,4393,3328,37.60194778442383,3.985166549682617,30.51900863647461,21.69489860534668,42.07468032836914
638,4733,8009,3276,458,3.1337738037109375,1.447916030883789,2.7277469635009766,2.0058155059814453,4.259824752807617
639,3069,6122,3053,4758,47.41501808166504,4.130125045776367,48.91014099121094,34.105777740478516,66.33996963500977
640,5916,6860,944,382,4.703044891357422,2.7327537536621094,2.804994583129883,1.5881061553955078,3.412008285522461
641,1206,1744,538,4649,45.710086822509766,3.180980682373047,44.56210136413574,29.701948165893555,62.72101402282715
642,1300,5461,4161,556,3.9949417114257812,1.1589527130126953,3.7050247192382812,2.557039260864258,5.328893661499023
643,576,7463,6887,2196,19.670963287353516,2.5327205657958984,18.7070369720459,13.844966888427734,25.8939266204834
644,2311,5733,3422,3846,40.89498519897461,3.323078155517578,40.97795486450195,28.254985809326172,50.74000358581543
645,1407,4219,2812,3578,34.10696983337402,2.8829574584960938,39.762258529663086,24.84726905822754,45.77302932739258
646,379,5917,5538,2656,25.968074798583984,2.6831626892089844,25.007963180541992,16.699790954589844,33.40601921081543
647,3201,8838,5637,2119,21.4841365814209,2.724170684814453,18.476009368896484,12.829065322875977,25.515079498291016
648,6341,9798,3457,807,6.131172180175781,1.940011978149414,5.731105804443359,3.9937496185302734,8.213996887207031
649,2455,8145,5690,1928,18.670082092285156,2.490997314453125,15.964984893798828,11.744976043701172,21.28314971923828
650,2954,3631,677,3752,35.89797019958496,3.015279769897461,32.46903419494629,26.697874069213867,49.64590072631836
651,6450,9700,3250,3441,36.80777549743652,3.5982131958007812,32.97281265258789,23.38409423828125,44.17991638183594
652,6217,7920,1703,4129,41.64719581604004,3.772258758544922,40.66109657287598,27.518033981323242,55.22894859313965
653,3912,9066,5154,47,0.2129077911376953,1.2958049774169922,0.15997886657714844,0.11396408081054688,0.2560615539550781
654,3831,7605,3774,74,0.34999847412109375,1.110076904296875,0.3173351287841797,0.17881393432617188,0.4489421844482422
655,2924,4238,1314,1612,16.403913497924805,1.6298294067382812,13.283967971801758,9.098052978515625,19.249916076660156
656,3412,5063,1651,2855,26.417970657348633,2.5300979614257812,25.761842727661133,17.806053161621094,36.8199348449707
657,3432,9953,6521,4328,46.029090881347656,4.505157470703125,41.41807556152344,33.41269493103027,59.73100662231445
658,2930,3309,379,3576,34.15274620056152,2.695798873901367,30.890941619873047,21.26479148864746,45.26996612548828
659,3140,7375,4235,4682,46.05698585510254,4.051923751831055,50.952911376953125,32.801151275634766,62.712907791137695
660,3528,5229,1701,1323,10.9100341796875,1.5969276428222656,9.930849075317383,7.351875305175781,14.925003051757812
661,978,2447,1469,2540,22.98283576965332,1.9447803497314453,21.223068237304688,16.124963760375977,31.310081481933594
662,2352,5249,2897,4091,42.318105697631836,3.465890884399414,39.48378562927246,27.62293815612793,54.132938385009766
663,2400,5554,3154,703,5.363941192626953,1.260995864868164,4.760980606079102,3.335714340209961,6.975889205932617
664,3214,9696,6482,4239,41.23115539550781,4.153013229370117,46.03695869445801,29.09684181213379,55.63926696777344
665,5588,7885,2297,346,4.253149032592773,1.4510154724121094,3.998994827270508,1.8761157989501953,3.251314163208008
666,806,1732,926,4251,45.78685760498047,3.1549930572509766,42.89817810058594,27.87184715270996,62.90578842163086
667,717,8659,7942,765,5.764961242675781,1.7731189727783203,5.4340362548828125,3.757953643798828,7.630109786987305
668,1443,2645,1202,3149,29.521942138671875,2.379894256591797,28.851032257080078,19.849061965942383,39.14380073547363
669,555,1906,1351,2422,23.546934127807617,1.9810199737548828,21.684885025024414,17.01664924621582,29.51788902282715
670,485,7636,7151,1021,8.108139038085938,2.897024154663086,9.176015853881836,5.631446838378906,10.184049606323242
671,2197,4685,2488,420,2.8018951416015625,0.9381771087646484,2.593994140625,1.8093585968017578,4.470109939575195
672,3512,5327,1815,4664,45.536041259765625,3.675699234008789,44.80481147766113,33.280134201049805,61.23685836791992
673,4858,7291,2433,3341,31.625986099243164,3.214120864868164,29.258012771606445,21.853923797607422,41.674137115478516
674,191,7526,7335,1510,12.69388198852539,2.1088123321533203,11.72780990600586,8.693933486938477,17.006874084472656
675,8501,9736,1235,1021,9.189128875732422,2.5589466094970703,9.91058349609375,5.862951278686523,12.202978134155273
676,1496,9588,8092,3973,39.26992416381836,4.048824310302734,37.37998008728027,27.16684341430664,54.48102951049805
677,1837,4338,2501,400,2.666950225830078,0.8752346038818359,2.3789405822753906,1.741170883178711,4.948854446411133
678,858,906,48,963,7.849931716918945,0.6949901580810547,6.414890289306641,4.5299530029296875,10.114908218383789
679,3481,9358,5877,105,0.5660057067871094,1.5780925750732422,0.4680156707763672,0.3020763397216797,0.6949901580810547
680,1533,9929,8396,4862,51.245927810668945,4.703998565673828,50.788164138793945,33.972978591918945,64.96524810791016
681,567,3963,3396,1142,10.385990142822266,1.3201236724853516,8.601188659667969,6.274700164794922,12.300968170166016
682,2957,3621,664,74,0.3867149353027344,0.5650520324707031,0.3032684326171875,0.18310546875,0.44798851013183594
683,3083,7769,4686,1845,17.297983169555664,2.357959747314453,16.91603660583496,11.214971542358398,22.796630859375
684,500,5721,5221,1357,11.36016845703125,1.7499923706054688,11.394977569580078,7.817983627319336,15.4266357421875
685,2523,4088,1565,701,5.177974700927734,1.0411739349365234,4.847049713134766,3.2949447631835938,7.0819854736328125
686,3298,8180,4882,2961,28.9919376373291,3.1027793884277344,29.78825569152832,19.300222396850586,37.795066833496094
687,1926,6939,5013,896,7.380962371826172,1.622915267944336,6.561994552612305,5.052089691162109,10.13493537902832
688,2571,2841,270,2801,30.384063720703125,2.225160598754883,24.024009704589844,18.9666748046875,42.38104820251465
689,4287,6881,2594,848,7.2460174560546875,1.9152164459228516,8.640050888061523,4.739284515380859,10.463953018188477
690,4789,9874,5085,443,3.622770309448242,2.045869827270508,3.7221908569335938,2.6319026947021484,4.582881927490234
691,2532,8201,5669,1867,20.292043685913086,2.880096435546875,19.893884658813477,11.806964874267578,22.257089614868164
692,3193,5299,2106,4297,46.550750732421875,5.155086517333984,42.144060134887695,31.820058822631836,63.42196464538574
693,5520,7492,1972,3427,36.12184524536133,3.670930862426758,38.29622268676758,24.798154830932617,46.26607894897461
694,3316,6006,2690,4591,48.90584945678711,4.03594970703125,50.29892921447754,35.42780876159668,68.62378120422363
695,5677,7513,1836,1481,13.537883758544922,2.131223678588867,14.467954635620117,9.41610336303711,17.3187255859375
696,6376,8414,2038,923,7.177114486694336,2.0880699157714844,9.184837341308594,5.465030670166016,11.503934860229492
697,3800,5960,2160,1681,16.327857971191406,2.1507740020751953,18.61095428466797,11.233091354370117,21.314144134521484
698,2122,3642,1520,3149,33.029794692993164,2.496957778930664,34.3480110168457,23.44202995300293,42.88363456726074
699,42,228,186,1113,8.961915969848633,0.6270408630371094,7.792949676513672,5.419015884399414,11.747121810913086
700,152,5113,4961,3242,30.63511848449707,2.9249191284179688,35.063982009887695,21.02184295654297,40.82298278808594
701,3696,5938,2242,966,7.595062255859375,1.4820098876953125,6.840705871582031,5.052804946899414,10.007143020629883
702,388,2215,1827,1069,8.544921875,1.0056495666503906,7.998943328857422,5.641937255859375,11.184930801391602
703,3922,5925,2003,2860,27.749061584472656,2.8247833251953125,28.423070907592773,20.06077766418457,37.796735763549805
704,2499,4135,1636,906,7.818937301635742,1.325845718383789,7.824182510375977,5.156040191650391,10.167121887207031
705,285,1261,976,442,3.2601356506347656,0.49424171447753906,3.2410621643066406,2.026081085205078,4.307985305786133
706,5392,8693,3301,3563,35.34412384033203,3.506183624267578,38.11216354370117,25.396108627319336,47.093868255615234
707,260,4054,3794,1796,17.14611053466797,2.0258426666259766,16.590118408203125,11.918067932128906,22.324085235595703
708,1686,3166,1480,2239,20.809173583984375,1.9030570983886719,22.569894790649414,14.180183410644531,29.88600730895996
709,8436,9442,1006,3670,39.29615020751953,4.126310348510742,31.798124313354492,23.52619171142578,46.45395278930664
710,3867,6231,2364,1657,16.698122024536133,2.254009246826172,14.259815216064453,9.686708450317383,18.750905990600586
711,3406,9735,6329,2907,26.93915367126465,3.3020973205566406,26.287078857421875,18.50295066833496,37.815093994140625
712,5122,8441,3319,3774,37.42694854736328,3.6017894744873047,33.987998962402344,25.239229202270508,45.629024505615234
713,4205,8217,4012,747,5.6171417236328125,1.6760826110839844,5.307197570800781,3.597736358642578,7.558345794677734
714,254,9053,8799,2515,24.859189987182617,3.4151077270507812,21.914005279541016,18.16082000732422,33.65969657897949
715,1657,8306,6649,4234,44.71588134765625,4.621982574462891,53.44891548156738,32.47189521789551,63.00687789916992
716,2236,4813,2577,3428,37.840843200683594,3.1299591064453125,38.27524185180664,25.536060333251953,49.93319511413574
717,5566,5806,240,522,4.745960235595703,1.8477439880371094,3.657102584838867,2.6810169219970703,5.401849746704102
718,3684,5399,1715,3985,45.90916633605957,3.7648677825927734,47.25193977355957,30.05695343017578,60.178279876708984
719,7251,8357,1106,1468,15.774965286254883,2.9261112213134766,13.313055038452148,9.155035018920898,18.977880477905273
720,742,3054,2312,698,6.000041961669922,1.4460086822509766,5.347251892089844,3.8008689880371094,7.129669189453125
721,4607,7771,3164,2496,25.721073150634766,2.941131591796875,25.112628936767578,16.952037811279297,34.461021423339844
722,310,7237,6927,1142,11.394023895263672,2.275228500366211,9.350061416625977,6.784915924072266,13.893842697143555
723,1614,4019,2405,2638,28.38611602783203,2.257108688354492,27.142763137817383,17.736196517944336,36.32998466491699
724,505,5301,4796,3403,35.62784194946289,3.162860870361328,34.75499153137207,22.609233856201172,44.5401668548584
725,2970,5642,2672,913,7.391929626464844,1.4190673828125,6.551980972290039,5.279779434204102,10.23411750793457
726,8050,8549,499,2838,27.966022491455078,3.1261444091796875,24.04189109802246,19.233226776123047,35.97712516784668
727,3410,6717,3307,4017,39.8409366607666,3.515005111694336,38.709163665771484,26.665210723876953,52.11901664733887
728,5912,9314,3402,4171,41.037797927856445,3.965139389038086,41.56804084777832,30.092716217041016,57.30891227722168
729,327,2746,2419,981,8.64100456237793,1.1782646179199219,7.912158966064453,5.665063858032227,10.996818542480469
730,6283,9729,3446,656,4.954099655151367,2.560138702392578,5.761146545410156,3.5698413848876953,7.261991500854492
731,4746,7108,2362,3595,36.92483901977539,3.7190914154052734,39.59488868713379,25.90012550354004,46.56481742858887
732,371,8258,7887,1901,16.83807373046875,2.4802684783935547,16.78776741027832,11.507987976074219,22.46999740600586
733,3336,8116,4780,3766,36.93580627441406,3.8237571716308594,33.85186195373535,25.649070739746094,47.34206199645996
734,316,9970,9654,4335,44.65508460998535,4.508018493652344,46.15592956542969,31.45599365234375,60.36496162414551
735,8858,9752,894,2084,22.37105369567871,3.56292724609375,19.407033920288086,14.553070068359375,28.96904945373535
736,6,2478,2472,4326,50.14491081237793,3.963947296142578,45.38607597351074,35.089731216430664,57.81292915344238
737,9145,9398,253,3645,35.794734954833984,3.6656856536865234,30.605792999267578,21.637916564941406,46.991825103759766
738,1554,4452,2898,2621,28.016090393066406,2.3200511932373047,26.513099670410156,18.611907958984375,33.76483917236328
739,3468,9275,5807,3512,33.65683555603027,3.6039352416992188,34.445762634277344,23.373126983642578,45.76516151428223
740,4346,5686,1340,3548,35.096168518066406,3.041982650756836,37.41717338562012,23.337125778198242,49.80897903442383
741,4994,5305,311,4459,54.474830627441406,3.7801265716552734,46.813011169433594,29.546022415161133,62.367916107177734
742,113,4251,4138,153,0.9100437164306641,0.7908344268798828,0.7319450378417969,0.51116943359375,1.1649131774902344
743,1338,2520,1182,2628,25.0699520111084,2.0961761474609375,24.500370025634766,16.517162322998047,33.638715744018555
744,3705,8761,5056,2110,20.80702781677246,2.7451515197753906,18.39303970336914,14.97793197631836,25.037050247192383
745,5784,8602,2818,3217,38.84005546569824,4.273891448974609,35.35914421081543,32.34505653381348,51.87201499938965
746,194,1637,1443,3810,49.80111122131348,3.056049346923828,44.33798789978027,27.201175689697266,52.57010459899902
747,2891,3595,704,849,6.551980972290039,1.0638236999511719,8.365869522094727,4.318952560424805,8.792877197265625
748,4352,6168,1816,1972,17.843961715698242,2.2411346435546875,16.75105094909668,12.20393180847168,23.594141006469727
749,5196,5825,629,2876,30.569076538085938,2.6459693908691406,27.174949645996094,21.44002914428711,36.437034606933594
750,581,1252,671,2349,21.84915542602539,1.7201900482177734,19.947052001953125,18.851041793823242,32.067060470581055
751,2795,7053,4258,1781,16.11495018005371,2.187013626098633,17.619848251342773,10.73002815246582,21.054983139038086
752,1276,5508,4232,844,7.367849349975586,1.67083740234375,8.095979690551758,4.478931427001953,10.201215744018555
753,523,6329,5806,4923,59.107065200805664,6.71696662902832,53.650856018066406,36.708831787109375,70.87492942810059
754,6626,9750,3124,1412,12.848138809204102,2.504110336303711,12.363195419311523,8.810043334960938,15.580177307128906
755,4581,5643,1062,505,3.632783889770508,1.1279582977294922,3.2939910888671875,2.3589134216308594,4.946231842041016
756,7379,8972,1593,1938,17.917156219482422,2.524852752685547,16.542911529541016,11.471748352050781,22.8579044342041
757,2961,4570,1609,2038,23.31399917602539,2.151966094970703,17.44818687438965,12.310028076171875,24.61695671081543
758,1657,4847,3190,4973,50.88210105895996,3.8208961486816406,48.38299751281738,37.07122802734375,68.38321685791016
759,1646,4638,2992,2669,25.65598487854004,2.454996109008789,24.84297752380371,16.906023025512695,32.562971115112305
760,2776,7384,4608,3193,29.978275299072266,3.141164779663086,30.05218505859375,20.964860916137695,44.419050216674805
761,3045,6256,3211,1605,15.543937683105469,2.068042755126953,13.091087341308594,9.460210800170898,18.311023712158203
762,3249,9430,6181,268,1.7740726470947266,1.5616416931152344,1.435995101928711,1.0161399841308594,2.178192138671875
763,2452,4548,2096,488,3.4608840942382812,0.9670257568359375,2.9382705688476562,2.5069713592529297,4.937887191772461
764,3902,9289,5387,3545,36.02099418640137,3.7679672241210938,37.67871856689453,24.522066116333008,51.5289306640625
765,225,3725,3500,819,6.678104400634766,2.1719932556152344,6.824016571044922,4.562854766845703,9.826898574829102
766,3536,9851,6315,2705,31.69083595275879,4.734992980957031,26.926040649414062,19.71888542175293,40.42482376098633
767,4320,9189,4869,3711,48.76399040222168,6.247997283935547,49.64923858642578,30.399799346923828,56.18095397949219
768,2662,5943,3281,1986,22.596120834350586,2.1948814392089844,18.459081649780273,15.590190887451172,28.01823616027832
769,1245,9428,8183,2320,23.502111434936523,4.19306755065918,23.519039154052734,16.41082763671875,34.13224220275879
770,5475,7509,2034,3991,45.88007926940918,4.114866256713867,43.721914291381836,31.14795684814453,59.98420715332031
771,1449,6433,4984,4134,50.0338077545166,4.39906120300293,51.86772346496582,34.61289405822754,60.19401550292969
772,3543,4689,1146,827,8.120059967041016,1.374959945678711,6.106853485107422,4.165172576904297,8.659124374389648
773,950,9319,8369,252,1.5239715576171875,1.4698505401611328,1.4009475708007812,0.9467601776123047,2.012014389038086
774,5328,7896,2568,725,6.6318511962890625,1.7619132995605469,5.309820175170898,3.5049915313720703,7.546663284301758
775,3306,6519,3213,3718,41.11003875732422,6.3228607177734375,35.96806526184082,25.33411979675293,46.39577865600586
776,2858,7429,4571,1439,13.084888458251953,2.0418167114257812,12.78996467590332,8.137941360473633,16.40009880065918
777,1258,3259,2001,1244,10.500907897949219,1.3229846954345703,10.560750961303711,7.659912109375,14.577865600585938
778,2040,8025,5985,1134,10.751962661743164,1.9309520721435547,9.126901626586914,7.470846176147461,12.552022933959961
779,6838,7437,599,950,7.644176483154297,1.6710758209228516,6.834983825683594,5.054950714111328,9.819984436035156
780,3753,4549,796,3614,39.08419609069824,2.899169921875,36.499977111816406,25.249958038330078,49.30377006530762
781,1692,9353,7661,3661,39.88480567932129,3.8590431213378906,36.827802658081055,26.72100067138672,51.661014556884766
782,1586,3893,2307,3515,37.58716583251953,3.0241012573242188,33.46896171569824,25.307893753051758,51.66172981262207
783,100,2053,1953,3449,33.75697135925293,2.460002899169922,32.06181526184082,22.85003662109375,46.43678665161133
784,1971,6718,4747,155,0.8459091186523438,1.0390281677246094,0.7197856903076172,0.49614906311035156,1.1088848114013672
785,3480,5685,2205,2501,22.855043411254883,2.4251937866210938,23.300886154174805,15.48314094543457,30.152082443237305
786,171,2650,2479,3515,33.206939697265625,2.640962600708008,32.75918960571289,25.238037109375,44.72804069519043
787,7336,9525,2189,2891,26.958942413330078,3.1890869140625,26.005983352661133,18.377065658569336,38.691043853759766
788,4594,5333,739,3212,30.067920684814453,2.7489662170410156,29.300928115844727,20.148038864135742,41.602134704589844
789,2674,7757,5083,4507,47.09911346435547,3.9908885955810547,47.99699783325195,30.614137649536133,58.686256408691406
790,4181,5786,1605,908,7.080078125,1.4128684997558594,6.376028060913086,4.734039306640625,9.354114532470703
791,5028,5949,921,209,1.207113265991211,0.9648799896240234,1.024007797241211,0.7109642028808594,1.6129016876220703
792,5503,6545,1042,1300,10.73598861694336,1.7461776733398438,10.34998893737793,7.019996643066406,14.194965362548828
793,2017,8586,6569,2106,18.702030181884766,2.6209354400634766,18.989086151123047,12.784719467163086,27.981042861938477
794,4947,5774,827,3005,28.579235076904297,3.9229393005371094,28.220176696777344,20.547151565551758,38.76614570617676
795,5778,8011,2233,1960,18.267154693603516,2.4030208587646484,16.032934188842773,11.419057846069336,22.603988647460938
796,36,3711,3675,4261,41.63503646850586,3.4542083740234375,39.138078689575195,29.27684783935547,52.71005630493164
797,2479,7457,4978,2502,22.719860076904297,2.7730464935302734,22.73702621459961,15.681743621826172,30.3499698638916
798,4848,7347,2499,2618,24.10292625427246,2.7201175689697266,23.663043975830078,16.26896858215332,31.930923461914062
799,6622,8429,1807,4456,43.92099380493164,4.004716873168945,45.54915428161621,29.579877853393555,60.64319610595703
800,6836,9769,2933,1491,12.576818466186523,2.3801326751708984,11.545658111572266,8.613109588623047,16.838788986206055
801,6579,7139,560,4541,44.99506950378418,3.8352012634277344,41.19873046875,28.748035430908203,60.06503105163574
802,3643,4420,777,1505,12.731790542602539,1.5728473663330078,13.575077056884766,8.553028106689453,17.614126205444336
803,434,4900,4466,1188,11.716127395629883,1.6248226165771484,9.498119354248047,7.909059524536133,15.33818244934082
804,6010,6415,405,2400,24.529218673706055,2.4690628051757812,25.19989013671875,14.00899887084961,31.18109703063965
805,2016,5417,3401,1235,11.31892204284668,1.7468929290771484,10.325908660888672,7.277965545654297,14.663219451904297
806,4278,5482,1204,4351,44.922828674316406,3.506898880004883,40.58980941772461,30.159711837768555,56.68520927429199
807,3191,6581,3390,378,2.5157928466796875,1.1830329895019531,2.279996871948242,1.5940666198730469,3.3080577850341797
808,569,7243,6674,2702,24.83201026916504,2.8231143951416016,25.31599998474121,16.91913604736328,36.46421432495117
809,3066,8443,5377,2708,24.9788761138916,2.9921531677246094,24.604082107543945,17.304658889770508,33.26916694641113
810,5582,9899,4317,3715,36.73601150512695,3.9551258087158203,35.03608703613281,24.51014518737793,50.328969955444336
811,167,956,789,4338,42.39511489868164,2.808809280395508,38.77401351928711,28.186798095703125,60.82582473754883
812,263,9651,9388,1789,15.632152557373047,2.6061534881591797,15.666723251342773,10.673999786376953,20.60389518737793
813,4272,5778,1506,1457,15.358209609985352,1.8699169158935547,12.584924697875977,11.38615608215332,16.732215881347656
814,7017,8863,1846,1440,13.117074966430664,2.8269290924072266,13.752937316894531,8.101940155029297,17.47298240661621
815,2688,4288,1600,1520,15.049934387207031,1.5859603881835938,12.109041213989258,8.714914321899414,17.244338989257812
816,3863,5435,1572,584,4.272222518920898,1.1589527130126953,3.74603271484375,2.721071243286133,6.633281707763672
817,1387,2961,1574,3668,36.68975830078125,2.7310848236083984,34.52706336975098,23.986339569091797,44.10219192504883
818,3602,8967,5365,2103,18.733978271484375,2.6650428771972656,19.655942916870117,12.805938720703125,24.654865264892578
819,4456,9626,5170,2594,25.789260864257812,3.3011436462402344,21.921873092651367,16.457796096801758,31.382083892822266
820,460,9314,8854,3698,35.33792495727539,3.9598941802978516,33.831119537353516,24.959325790405273,49.48306083679199
821,4328,6077,1749,4504,47.1799373626709,3.9060115814208984,45.372962951660156,35.137176513671875,64.24379348754883
822,1609,6021,4412,1467,12.306928634643555,1.8401145935058594,11.951208114624023,8.345842361450195,19.176006317138672
823,1871,7236,5365,4109,40.183067321777344,3.663778305053711,39.94917869567871,29.85382080078125,61.56206130981445
824,4542,8963,4421,4292,48.59781265258789,4.694223403930664,40.849924087524414,28.622150421142578,55.487871170043945
825,256,1914,1658,3250,30.511856079101562,2.312898635864258,31.14914894104004,20.80082893371582,40.41719436645508
826,4971,5437,466,463,3.171205520629883,1.0690689086914062,3.3075809478759766,1.97601318359375,4.21905517578125
827,6092,6366,274,3952,38.27095031738281,3.3309459686279297,34.7592830657959,23.183107376098633,50.28510093688965
828,6486,9065,2579,3483,34.011125564575195,3.503084182739258,31.479835510253906,25.046110153198242,43.843746185302734
829,2239,9989,7750,3121,29.204130172729492,3.4868717193603516,30.245065689086914,19.942045211791992,38.68293762207031
830,7925,8557,632,2119,18.746137619018555,2.537250518798828,18.42784881591797,12.105941772460938,24.823904037475586
831,5678,6777,1099,1171,10.859012603759766,1.7361640930175781,8.414983749389648,6.319761276245117,12.542009353637695
832,5161,9181,4020,3650,38.93780708312988,3.731966018676758,34.15226936340332,24.49822425842285,47.39785194396973
833,1273,7103,5830,924,7.276773452758789,1.6529560089111328,8.287906646728516,5.644083023071289,10.785102844238281
834,2118,2194,76,3933,41.40496253967285,2.7358531951904297,31.198978424072266,20.362138748168945,50.03213882446289
835,6476,8891,2415,3844,40.08889198303223,3.8690567016601562,37.64200210571289,28.174877166748047,54.07571792602539
836,260,4327,4067,2437,22.151947021484375,2.209186553955078,22.053956985473633,15.213251113891602,29.143095016479492
837,1427,2213,786,4876,48.57182502746582,3.328561782836914,43.099164962768555,33.09893608093262,64.16988372802734
838,3553,6070,2517,3447,32.652854919433594,3.0460357666015625,34.66796875,22.3691463470459,41.22495651245117
839,1131,7864,6733,1123,9.087800979614258,1.9059181213378906,9.239673614501953,5.995035171508789,11.953115463256836
840,3097,6171,3074,178,0.9949207305908203,0.9760856628417969,1.1479854583740234,0.6310939788818359,1.3570785522460938
841,2099,7662,5563,4765,47.132253646850586,4.128217697143555,46.552181243896484,34.027099609375,63.45987319946289
842,1885,7533,5648,2144,22.31597900390625,2.508878707885742,20.920991897583008,14.275074005126953,25.501012802124023
843,1668,4664,2996,1940,17.44222640991211,1.9218921661376953,15.620231628417969,11.46697998046875,22.54509925842285
844,5835,6425,590,2815,26.0622501373291,3.1669139862060547,24.85513687133789,17.051219940185547,34.23118591308594
845,159,6768,6609,2327,21.078109741210938,2.525806427001953,20.555973052978516,14.37687873840332,30.40790557861328
846,2400,6362,3962,2470,22.485017776489258,2.513885498046875,21.831989288330078,18.214941024780273,34.065961837768555
847,6815,7466,651,3224,30.33280372619629,3.0798912048339844,28.3358097076416,19.91105079650879,41.24307632446289
848,4930,7188,2258,1698,14.773368835449219,2.119779586791992,13.458013534545898,12.456893920898438,20.253896713256836
849,5415,8510,3095,1010,9.397029876708984,2.0599365234375,8.084297180175781,6.231069564819336,10.850667953491211
850,3926,5560,1634,3705,35.835981369018555,3.152132034301758,34.171104431152344,24.496078491210938,50.72426795959473
851,6885,7858,973,1703,14.688968658447266,2.215147018432617,13.506889343261719,9.741067886352539,19.279956817626953
852,4614,9503,4889,3046,28.72776985168457,3.337860107421875,30.087947845458984,24.934053421020508,42.44875907897949
853,2298,3373,1075,4914,55.96280097961426,3.5490989685058594,50.2467155456543,34.320831298828125,68.35794448852539
854,5599,9082,3483,4182,41.40210151672363,4.009008407592773,41.996002197265625,28.09596061706543,54.90994453430176
855,4979,7005,2026,2196,20.086050033569336,2.440929412841797,18.481016159057617,16.005277633666992,30.54213523864746
856,695,5760,5065,4950,49.3621826171875,3.988981246948242,50.52304267883301,33.92601013183594,65.54388999938965
857,2807,2898,91,1524,12.974262237548828,1.3248920440673828,12.737035751342773,7.899999618530273,16.923904418945312
858,750,1187,437,4752,47.66201972961426,3.113985061645508,41.561126708984375,29.752016067504883,62.64901161193848
859,3100,5667,2567,1548,13.185977935791016,1.8169879913330078,12.930870056152344,9.08803939819336,16.726970672607422
860,1886,5530,3644,3926,45.00603675842285,3.7429332733154297,42.613983154296875,28.0001163482666,53.1160831451416
861,7914,9767,1853,540,3.8509368896484375,1.7468929290771484,3.690958023071289,2.457141876220703,5.059242248535156
862,3948,4692,744,4150,40.5120849609375,3.248929977416992,37.91213035583496,29.507160186767578,55.95088005065918
863,1836,5292,3456,4793,48.18010330200195,3.759145736694336,46.49496078491211,36.071062088012695,62.99424171447754
864,7540,9054,1514,2067,18.823862075805664,2.7718544006347656,17.46201515197754,12.589693069458008,24.600982666015625
865,2267,2419,152,3717,35.86316108703613,2.6307106018066406,30.07793426513672,20.668745040893555,47.7900505065918
866,1773,8095,6322,3643,35.24184226989746,3.534078598022461,36.65518760681152,25.947093963623047,46.263933181762695
867,799,5041,4242,3848,38.77401351928711,4.09388542175293,41.19992256164551,26.594161987304688,53.540945053100586
868,6767,8862,2095,1840,16.399145126342773,4.17017936706543,23.40412139892578,10.750055313110352,21.037817001342773
869,1047,6967,5920,2492,22.83787727355957,2.640962600708008,22.588253021240234,16.019344329833984,30.22599220275879
870,2573,5264,2691,1271,10.52403450012207,1.5861988067626953,10.065078735351562,6.918907165527344,13.679027557373047
871,4922,5306,384,1436,12.152910232543945,1.6722679138183594,11.134147644042969,7.562875747680664,15.813112258911133
872,756,2483,1727,352,2.2640228271484375,0.6630420684814453,1.9671916961669922,1.458883285522461,3.0448436737060547
873,1344,9283,7939,2304,20.907163619995117,2.9070377349853516,20.25604248046875,14.250040054321289,27.185916900634766
874,1298,5154,3856,257,1.5659332275390625,0.8709430694580078,1.3277530670166016,0.9298324584960938,2.0461082458496094
875,3339,3426,87,2611,23.950815200805664,2.0411014556884766,19.23370361328125,13.123035430908203,31.426668167114258
876,5056,8302,3246,4826,48.41279983520508,4.518985748291016,52.49595642089844,33.20193290710449,64.70799446105957
877,2112,5277,3165,1861,16.256093978881836,1.9750595092773438,15.76089859008789,11.06405258178711,21.26288414001465
878,1123,8422,7299,3044,28.309106826782227,3.2351016998291016,31.881093978881836,21.74687385559082,38.70081901550293
879,7681,9896,2215,616,4.471063613891602,1.8208026885986328,5.24592399597168,2.8748512268066406,5.955696105957031
880,2438,8218,5780,1131,9.087085723876953,1.950979232788086,9.123086929321289,6.100893020629883,11.593818664550781
881,3599,9932,6333,358,2.32696533203125,1.6558170318603516,2.2177696228027344,1.4262199401855469,3.216981887817383
882,1243,6012,4769,691,5.129098892211914,1.3301372528076172,5.063772201538086,3.390073776245117,6.767034530639648
883,6690,8493,1803,1991,17.505884170532227,2.479076385498047,16.5250301361084,11.739253997802734,23.751020431518555
884,2864,4609,1745,4315,43.740034103393555,3.400087356567383,41.14508628845215,28.6710262298584,55.84907531738281
885,8354,9196,842,4948,49.06916618347168,4.366874694824219,43.75505447387695,32.1810245513916,68.22991371154785
886,8861,9381,520,2160,19.294023513793945,2.7611255645751953,17.596006393432617,12.482643127441406,25.269031524658203
887,1287,1868,581,4096,40.30299186706543,2.788066864013672,38.725852966308594,28.177976608276367,52.390098571777344
888,230,7974,7744,3909,37.60790824890137,3.738880157470703,37.98198699951172,26.640892028808594,53.36713790893555
889,8277,8797,520,2618,23.83899688720703,2.9020309448242188,22.181272506713867,15.426158905029297,31.932830810546875
890,468,2858,2390,503,3.511190414428711,0.7379055023193359,3.3469200134277344,2.269268035888672,4.608631134033203
891,3242,5425,2183,1962,17.42100715637207,2.023935317993164,17.50016212463379,12.93802261352539,25.534868240356445
892,6731,9190,2459,278,1.8389225006103516,1.531839370727539,1.4841556549072266,1.191854476928711,2.975940704345703
893,5538,7399,1861,13,0.08416175842285156,1.6329288482666016,0.03409385681152344,0.022172927856445312,0.05507469177246094
894,4909,7716,2807,388,2.9709339141845703,1.5981197357177734,2.4881362915039062,1.7330646514892578,4.183053970336914
895,4064,7237,3173,3025,31.728029251098633,3.0031204223632812,29.968976974487305,19.16813850402832,37.303924560546875
896,1337,7944,6607,1127,9.045124053955078,1.91497802734375,9.257078170776367,6.129980087280273,11.893033981323242
897,5233,6328,1095,1161,9.67097282409668,1.6379356384277344,8.84389877319336,6.2847137451171875,12.391328811645508
898,768,8701,7933,4952,49.2701530456543,4.463911056518555,48.426151275634766,34.811973571777344,69.22626495361328
899,166,6749,6583,4626,47.00589179992676,3.957986831665039,48.02989959716797,32.04798698425293,63.69495391845703
900,2657,7647,4990,336,2.167940139770508,1.3082027435302734,1.9199848175048828,1.3492107391357422,2.864837646484375
901,664,830,166,4332,42.21677780151367,2.75421142578125,36.715030670166016,24.973154067993164,53.591012954711914
902,376,3198,2822,292,1.8990039825439453,0.6508827209472656,1.7969608306884766,1.15203857421875,2.5060176849365234
903,5182,7942,2760,1377,11.525869369506836,2.033233642578125,11.00921630859375,7.6999664306640625,15.052080154418945
904,1625,6228,4603,3643,34.61599349975586,3.2172203063964844,34.279823303222656,25.421142578125,46.70095443725586
905,6642,7726,1084,915,7.074117660522461,1.6827583312988281,7.889747619628906,4.667043685913086,9.618997573852539
906,1698,7330,5632,1516,13.611078262329102,2.315044403076172,11.929988861083984,9.126901626586914,17.33708381652832
907,5602,9264,3662,32,0.13494491577148438,1.6720294952392578,0.1900196075439453,0.1270771026611328,0.30493736267089844
908,5666,9673,4007,2032,20.7674503326416,2.7129650115966797,17.189741134643555,12.172937393188477,23.517370223999023
909,4537,7838,3301,488,3.386974334716797,1.4426708221435547,3.0760765075683594,2.2857189178466797,4.472017288208008
910,899,4741,3842,3528,35.340070724487305,2.9287338256835938,33.07390213012695,23.439884185791016,44.38924789428711
911,3560,7737,4177,1827,15.947103500366211,2.3839473724365234,15.373945236206055,10.779142379760742,21.152019500732422
912,3939,9377,5438,4569,45.008182525634766,4.256010055541992,47.51992225646973,34.529924392700195,62.18695640563965
913,4173,8840,4667,1558,13.187646865844727,2.3369789123535156,13.605833053588867,8.882999420166016,17.563819885253906
914,4284,7176,2892,4817,47.26099967956543,4.04667854309082,50.099849700927734,33.119916915893555,63.20810317993164
915,8462,9369,907,2483,22.397994995117188,2.933025360107422,22.584199905395508,14.847993850708008,29.6781063079834
916,2546,2619,73,106,0.5512237548828125,0.43773651123046875,0.4191398620605469,0.30612945556640625,0.6859302520751953
917,6207,9791,3584,3084,32.232046127319336,3.5741329193115234,28.676986694335938,20.534038543701172,39.59798812866211
918,2461,9271,6810,2986,29.218196868896484,3.286123275756836,27.08292007446289,19.243955612182617,37.01496124267578
919,8811,9091,280,1306,10.745048522949219,2.1038055419921875,9.318828582763672,6.906032562255859,14.43791389465332
920,5240,5325,85,1080,8.675098419189453,1.386880874633789,7.393121719360352,5.002021789550781,11.486053466796875
921,2887,9546,6659,3245,30.354976654052734,3.4818649291992188,29.658079147338867,21.125078201293945,43.84183883666992
922,5601,5950,349,376,2.51007080078125,1.0819435119628906,2.147197723388672,1.5628337860107422,3.1011104583740234
923,1384,8341,6957,2894,26.643991470336914,3.0820369720458984,26.173830032348633,18.45240592956543,35.427093505859375
924,2943,7656,4713,2564,23.214101791381836,2.753019332885742,22.57370948791504,16.13473892211914,30.988693237304688
925,4497,7902,3405,1886,16.4949893951416,2.446889877319336,16.337871551513672,11.06715202331543,24.741172790527344
926,42,3022,2980,30,0.13208389282226562,0.4589557647705078,0.09107589721679688,0.064849853515625,0.14281272888183594
927,4660,6379,1719,1093,8.823871612548828,1.6100406646728516,8.719205856323242,5.832910537719727,11.629104614257812
928,2154,4657,2503,4426,43.23410987854004,3.431081771850586,43.63393783569336,29.78515625,57.21116065979004
929,3263,3482,219,705,5.208253860473633,0.926971435546875,4.925251007080078,3.217935562133789,6.897926330566406
930,2381,5236,2855,2328,20.77507972717285,2.2373199462890625,22.104978561401367,15.666961669921875,32.003164291381836
931,4843,5371,528,1035,9.851932525634766,1.5177726745605469,8.279085159301758,5.761146545410156,11.749029159545898
932,2640,8253,5613,3265,35.823822021484375,3.854990005493164,29.302120208740234,21.151065826416016,40.949106216430664
933,3100,7929,4829,294,1.828908920288086,1.3072490692138672,1.7421245574951172,1.1348724365234375,2.413034439086914
934,1146,3796,2650,429,2.899169921875,0.8656978607177734,2.9501914978027344,1.837015151977539,3.8590431213378906
935,2227,6395,4168,4084,39.422035217285156,3.5178661346435547,39.492130279541016,27.444124221801758,52.17623710632324
936,1090,1662,572,4625,45.41277885437012,3.0777454376220703,42.7701473236084,29.60205078125,61.334848403930664
937,553,3142,2589,4879,49.00789260864258,3.5448074340820312,47.03092575073242,33.08272361755371,67.54803657531738
938,3509,4807,1298,1277,10.502815246582031,1.4910697937011719,10.158061981201172,7.0018768310546875,13.743877410888672
939,242,5289,5047,1103,8.867025375366211,1.50299072265625,9.11092758178711,5.95402717590332,11.677742004394531
940,1563,2558,995,4580,47.64819145202637,3.198862075805664,44.075965881347656,29.69503402709961,64.04685974121094
941,1045,6264,5219,4171,42.65189170837402,4.082202911376953,46.07510566711426,28.396129608154297,53.47299575805664
942,557,3862,3305,2417,21.891117095947266,2.1131038665771484,23.03600311279297,14.929056167602539,29.00099754333496
943,2615,6128,3513,4922,48.8131046295166,3.97491455078125,49.170732498168945,33.84208679199219,61.460018157958984
944,2089,4960,2871,3512,36.74197196960449,2.930879592895508,31.689882278442383,23.669958114624023,44.24691200256348
945,93,4489,4396,3041,28.200149536132812,2.5949478149414062,28.31101417541504,19.711017608642578,40.72117805480957
946,6582,8133,1551,20,0.07987022399902344,1.1739730834960938,0.05507469177246094,0.035762786865234375,0.08487701416015625
947,189,5871,5682,4141,41.35489463806152,3.536224365234375,38.967132568359375,27.877092361450195,53.99203300476074
948,4393,6310,1917,3124,29.018878936767578,2.8510093688964844,29.564857482910156,23.293018341064453,40.09103775024414
949,6794,7507,713,3454,34.38901901245117,3.39508056640625,32.24015235900879,21.49796485900879,43.81704330444336
950,5366,6427,1061,76,0.7832050323486328,1.8630027770996094,0.5660057067871094,0.41222572326660156,0.7379055023193359
951,196,2036,1840,11,0.04315376281738281,0.3108978271484375,0.029802322387695312,0.019788742065429688,0.03814697265625
952,824,6375,5551,217,1.4808177947998047,1.1718273162841797,1.3871192932128906,0.9069442749023438,1.8601417541503906
953,1909,6019,4110,701,5.400180816650391,1.3260841369628906,4.752874374389648,3.4058094024658203,6.819963455200195
954,3185,9881,6696,3686,35.35199165344238,3.857135772705078,33.788204193115234,24.419069290161133,47.26672172546387
955,1929,8236,6307,1849,16.23392105102539,2.4881362915039062,16.58010482788086,11.015176773071289,25.916099548339844
956,2622,4500,1878,3562,34.159183502197266,2.8748512268066406,33.02288055419922,22.93992042541504,45.176029205322266
957,1031,9349,8318,3906,42.099952697753906,3.889799118041992,38.93089294433594,29.267072677612305,50.52495002746582
958,6180,9185,3005,3173,35.125017166137695,3.8259029388427734,30.97081184387207,23.010969161987305,39.89815711975098
959,7878,8975,1097,1782,15.407085418701172,2.398967742919922,14.706850051879883,10.307788848876953,22.064924240112305
960,4270,4302,32,957,9.181976318359375,1.249074935913086,5.875110626220703,3.802061080932617,12.210845947265625
961,6885,7006,121,4663,53.63607406616211,4.124164581298828,40.83418846130371,26.525020599365234,61.68317794799805
962,874,8619,7745,1044,8.27789306640625,1.9538402557373047,8.050918579101562,5.508184432983398,10.87498664855957
963,5819,7270,1451,3295,34.75832939147949,4.177331924438477,29.48284149169922,22.446870803833008,41.1829948425293
964,359,4953,4594,2741,25.305747985839844,2.4871826171875,25.86984634399414,17.679929733276367,34.88302230834961
965,4909,9470,4561,4861,52.36983299255371,4.481077194213867,45.66383361816406,35.55703163146973,64.94903564453125
966,5622,7385,1763,594,4.267215728759766,1.4400482177734375,3.761768341064453,2.804994583129883,7.560014724731445
967,5609,9529,3920,861,7.457971572875977,2.106904983520508,6.085872650146484,4.327297210693359,8.734941482543945
968,869,9592,8723,259,1.5430450439453125,1.505136489868164,1.3611316680908203,0.9858608245849609,2.1491050720214844
969,7261,7564,303,3839,36.72289848327637,3.818988800048828,33.68496894836426,24.82318878173828,49.08180236816406
970,623,9507,8884,286,1.7669200897216797,1.5158653259277344,1.583099365234375,1.0991096496582031,2.3381710052490234
971,5143,9975,4832,4288,42.758941650390625,4.160881042480469,39.69979286193848,29.143095016479492,57.521820068359375
972,501,8865,8364,3585,35.26782989501953,3.615856170654297,34.37495231628418,24.739980697631836,49.427032470703125
973,182,2650,2468,3804,37.36114501953125,2.7780532836914062,34.19017791748047,25.320768356323242,48.211097717285156
974,2180,8974,6794,759,5.755186080932617,1.817941665649414,5.335807800292969,3.844022750854492,7.536888122558594
975,5597,5882,285,2010,17.670869827270508,2.064943313598633,15.455007553100586,12.712955474853516,23.22697639465332
976,6866,8716,1850,4445,43.322086334228516,4.00996208190918,45.39299011230469,32.43613243103027,58.37607383728027
977,4110,5179,1069,1567,13.22174072265625,1.7192363739013672,12.839078903198242,8.907079696655273,17.60721206665039
978,1027,3427,2400,4513,43.952226638793945,3.3071041107177734,46.02789878845215,30.71427345275879,59.120893478393555
979,6014,8553,2539,3578,36.553144454956055,3.767728805541992,35.385847091674805,23.0410099029541,46.26893997192383
980,2191,6691,4500,2930,29.73794937133789,2.8460025787353516,27.553081512451172,19.80304718017578,40.51518440246582
981,234,3708,3474,3307,31.566858291625977,2.627849578857422,29.711246490478516,21.176815032958984,41.61691665649414
982,3280,6603,3323,4017,38.6509895324707,3.4868717193603516,38.59686851501465,27.186870574951172,54.498910903930664
983,9100,9368,268,407,2.7239322662353516,1.5799999237060547,2.5348663330078125,1.6603469848632812,3.587961196899414
984,2743,5723,2980,3424,32.30881690979004,2.9981136322021484,32.067060470581055,22.45807647705078,42.807817459106445
985,3242,4970,1728,2421,21.815776824951172,2.2330284118652344,24.27816390991211,15.016794204711914,27.479171752929688
986,131,165,34,3980,38.468122482299805,2.1440982818603516,32.88102149963379,19.022226333618164,49.66020584106445
987,6751,7385,634,30,0.12922286987304688,1.0938644409179688,0.0858306884765625,0.06079673767089844,0.13685226440429688
988,1666,6063,4397,698,5.172014236450195,1.33514404296875,4.769086837768555,3.276824951171875,6.871223449707031
989,3349,4156,807,1184,9.557962417602539,1.3310909271240234,9.539127349853516,6.574153900146484,14.24098014831543
990,883,9657,8774,2218,22.764921188354492,2.9850006103515625,20.390748977661133,13.377904891967773,27.467966079711914
991,506,2901,2395,2269,20.47586441040039,1.9879341125488281,20.891904830932617,13.53597640991211,29.361963272094727
992,0,202,202,1739,16.620159149169922,1.0290145874023438,14.816761016845703,9.398937225341797,19.770145416259766
993,2999,5943,2944,913,7.068872451782227,2.8679370880126953,8.964061737060547,5.0029754638671875,10.085105895996094
994,154,8534,8380,1459,13.290166854858398,2.5091171264648438,12.688875198364258,8.831977844238281,17.980337142944336
995,4123,6852,2729,1906,17.930984497070312,2.2089481353759766,18.61286163330078,11.255979537963867,22.137165069580078
996,8758,9883,1125,2530,22.921085357666016,2.9878616333007812,24.314165115356445,15.90585708618164,30.3952693939209
997,414,3042,2628,418,2.791881561279297,0.7078647613525391,2.635955810546875,1.7788410186767578,3.7169456481933594
998,188,8846,8658,2057,18.141984939575195,2.6450157165527344,18.896102905273438,12.566089630126953,26.50594711303711
999,450,5701,5251,647,4.766941070556641,1.257181167602539,4.552364349365234,3.1099319458007812,6.273031234741211
